szczegółowo	in detail
skupiać się (wymowa)	to focus
w Zjednoczonym Królestwie	in the UK
być na prowizji	to work on commission
dalej	further
w pracy	at work
w mojej pierwszej pracy	in my first job
pracodawca	an employer
reagować na coś	to react to sth
w ostatni piątek	last Friday
pan młody	a groom
jedna trzecia	one third
samogłoska	a vowel
panna młoda	a bride
mieć coś zrobić	to be supposed to do sth
mieć w zwyczaju coś robić	to be used to doing sth
żyła	a vein
wierny	faithful
po pracy	after work
przygotowywać się do czegoś	to get prepared for sth
na stanowisku	in the position
płynność	fluency
w następną środę	next Wednesday
trzeźwy	sober
strzelnica	a rifle range
być na kacu	to be hungover
słuchać kogoś	to listen to sb
zdobywać czyjeś zaufanie	to earn sb's trust
wiedza (wymowa)	knowledge
przeklinać [2]	to curse; to swear
mówić coś więcej o czymś	to elaborate on sth
zdrowieć [2]	to recover; to get better
chodzić spać	to go to sleep
zatrzymywać kogoś	to detain sb
narzeczony (wymowa)	a fiance
ten drugi	the other one
odcinek	an episode
robić niespodziankę	to make a surprise
poronić	to miscarry
rodzić dziecko	to give birth to a child
godzić się z kimś [2]	to reconcile with sb; to make up with sb
agent nieruchomości	a real estate agent
pojawiać się [2]	to appear; to show up
oskarżać kogoś o coś	to accuse sb of sth
ciotka (wymowa)	an aunt
rocznica	an anniversary
masza święta	a Mass
ołtarz	an altar
kran	a faucet
poręcz	a handrail
na początku	at first
w ciągu miesiąca	within a month
wpływać na coś	to influence sth
mieć wpływ na coś	to have influence on sth
opieprzać kogoś	to tell sb off
kierunek (studiów)	a program
przedmiot akademicki	a course
doświadczenie zawodowe	work experience
zestresowany	stressed-out
panikować	to be in panic
o północy	at midnight
następnego dnia	(on) the next day
płytki	tiles
gniazdko [2]	an outlet; a socket
rura	a pipe
﻿robić grilla	to have a barbecue
zrzucać na kogoś winę	to put the blame on sb
zainteresowania	interests
iść na siłownię	to go to the gym
uczęszczać do szkoły	to attend school
brać udział w spotkaniu	to attend a meeting
zazdrosny	jealous
wsparcie	support
rozgrzewać się	to warm up
flirtować (wymowa)	to flirt
przedszkole	a kindergarten
zmusić kogoś do zrobienia czegoś	to force sb to do sth
terapeuta	a therapist
przebierać się za coś	to dress up as sth
przeszukiwać kogoś	to search sb
ostatecznie	eventually
pierwsza osoba, która coś zrobiła	the first person to do sth
ofiara	a victim
kierunkowskaz	an indicator
zwrot akcji	a twist in the plot
zagadka	a puzzle
robić notatki	to take notes
spółka matka	a parent company
interesować się czymś	to be interested in sth
popełnić samobójstwo	to commit suicide
rodzić	to be in labor
zaczynać rodzić	to go to labor
w ten piątek	this Friday
przypadkowo [2]	accidentally; by accident
nie być czymś zainteresowanym	to have no interest in sth
zdradzać kogoś	to cheat on sb
kłócić się z kimś [2]	to have an argument; to fall out
krzyczeć na kogoś [2]	to shout at sb; to scream at sb
potrącać kogoś	to knock sb down
uciekać	to flee
gapić się na kogoś	to stare at sb
zamykać drzwi	to shut the door
sejf	a safe
wpadać (do kogoś) [2]	to drop by; to come over
wpadać do kogoś	to drop in on sb
zastrzelić kogoś	to shoot sb dead
udawać się do szpitala	to go to the hospital
Rumunia	Romania
raz na dwa tygodnie	once every other week
odpowiadać na pytanie	to answer a question
skurcze	contractions
wracać do domu	to come back home
mieć ból głowy	to have a headache
węzeł chłonny	a lymph node
iść do lekarza	to go to the doctor
w internecie	on the Internet
bujać się w kimś	to be into sb
przyzwyczajać się do czegoś	to get used to sth
zjeżdżalnia	a slide
rozpowiadać coś	to spread sth
plotki	gossip
kolega z pracy	a colleague
półtorej godziny	an hour and a half
wprowadzać produkt na rynek	to launch a product; to roll out a product
zajmować się kimś	to take care of sb
towarzyski	sociable
mieć wiedzę z czegoś	to have knowledge of sth
mądrala	a know-it-all
znosić kogoś [2]	to stand sb; to put up with sb
zainteresowywać kogoś	to make sb interested
wyrażać siebie	to express myself
stanowić zagrożenie dla czegoś	to pose a risk to sth
osiągnięcie	an achievement
inwestować w coś	to invest in sth
widoczny	visible
zgodnie z planem	according to the plan
ganek	a porch
niepewny	insecure
rolety	roller blinds
apostrof	an apostrophe
zastawiać pułapkę	to set a trap
iść na randkę	to go on a date
wpadać na pomysł	to come up with an idea
zagraniczny	foreign
skierowanie do lekarza	a referral to the doctor
podczas jazdy	while driving
wycieńczający	draining
wypowiadać umowę	to terminate an agreement
właściciel	a landlord
lokator	a tenant
okres wypowiedzenia	a notice period
salon	a living room
rozwiązanie problemu	a solution to a problem
drużba	the best man
na zdjęciu	in the picture
kłócić się o coś [2]	to have an argument over sth; to fall out over sth
nawalić się (upić się)	to get wasted
podchmielony	tipsy
naćpany	stoned
ankieta	a survey
kłaść czemuś kres	to put sth to an end
dyrektor (szkoły)	a principal
pół godziny	half an hour
ogrzewanie	heating
klimatyzacja	air-conditioning
meldować się u kogoś (dawać znać lub sprawdzać, czy ktoś ma się dobrze)	to check in with sb
ciągnąć się	to drag on
przestrzeń	room
proces rekrutacyjny	a recruitment process
prowadzić spotkanie	to run a meeting
oparty na czymś	based on sth
być dla kogoś dobrą partią	to be a good match for sb
siedzieć przy stole	to sit at the table
kończyć pracę	to finish work
zaczynać pracę	to start work
panele podłogowe	floor panels
wyruszać	to set out
tylne siedzenie	a backseat
pralka	a washing machine
zmywarka	a dishwasher
artykuły gospodarstwa domowego	household appliances
płyta indukcyjna	an induction cooktop
robić postępy	to make progress
nakrywać do stołu	to set the table
czuć się dobrze (o nastroju)	to feel good
czuć się dobrze (zdrowo)	to feel well
napięty	tense
czas (w gramatyce)	a tense
napięcie	tension
namawiać kogoś do czegoś	to talk sb into sth
namawiać kogoś, żeby czegoś nie robił	to talk sb out of sth
całować się z kimś	to make out with sb
rozumieć coś (nie: understand)	to grasp sth
zaliczyć zgon	to have a blackout
szafa	a wardrobe
odbierać telefon	to pick up the phone
rozłączać się	to hang up
rzucić słuchawkę (podczas rozmowy z kimś)	to hang up on sb
walka	a fight; a struggle
wspólny znajomy	a mutual friend
odbierać kogoś z lotniska	to pick sb up from the airport
jak zwykle	as usual
rukola	arugula
stała cena	a fixed price
robić sobie przerwę	to take a break
chować kogoś (grzebać)	to bury sb
łapówka	a bribe
bukiet	a bouquet
u mnie	at my place
wpłacać pieniądze	to deposit money
zły na kogoś [2]	angry with sb; mad at sb
zamożny [2]	wealthy; well-off
dołączać do zespołu	to join the team
wezwanie do sądu	a subpoena
wzywać kogoś do sądu	to subpoena sb
prokurator	a prosecutor
zeznawać	to testify
ciężki dzień	a busy day
płot	a fence
ograniczać coś	to cut down on sth
schody	stairs
klatka schodowa	a stair case
podwórko	a yard
działka	a plot
podjazd	a driveway
kostka brukowa	a cobblestone
kopać dziurę	to dig a hole
słup	a pole
pręt	a bar
siatka	a net; a mesh
równy (o terenie)	even
sąd	a court
przestawać coś robić	to stop doing sth
zatrzymywać się, żeby coś zrobić	to stop to do sth
szafka	a locker
zazdrosny o kogoś	jealous of sb
przesłuchiwać kogoś [2]	to question sb; to interrogate sb
śmierć	a death
umierać	to die
martwy	dead
przyczyniać się do czegoś	to contribute to sth
zgłaszać coś	to report sth
mieć z kimś dobre stosunki	to have a good rapport with sb
dogadywać się z kimś	to get along with sb
przewracać się reponsibilities komuś	to turn over the reponsibilities to sb
brać nadgodziny	to work overtime
zapraszać kogoś na imprezę	to invite sb to a party
do balansuje na krawędzi czegoś	to teeter on the brink of sth
pracować zdalnie	to work remotely
chwalić się czegoś	to brag about sth
możliwość poprawy	room for improvement
nadrabiać zaległości	to catch up with sth
zrobić dobrą pracę	to do a good a job
przedłużyć kontrakt	to extend a contract
wygasać	to expire
wynajem	a hire
dostawać podwyżkę	to get a pay-raise
inwestować w sb	to invest in sb
mieć duże doświadczenie w czymś	to have a wide experience in sth
przygotowywać się na spotkanie	to get prepared for a meeting
robić krok	to take a step
racjonalny	rational
komplikacja	a setback
na początku [2]	at first; in the beginning
wdrażać kogoś	to onboard sb
pochopna decyzja	a hasty decision
w przyszłości	in the future
rozszerzać działalność	to expand a business
adwokat	an attorney
zaliczka	an advance payment
z góry	in advance
otrzymywać zwrot pieniędzy	to get a refund
dotrzymywać terminu	to meet a deadline
znaleźć punkt zaczepienia	to gain a foothold
dowody	evidence
podziwiać coś	to admire sth
w drodze do domu	on my way home
notariusz	a notary
niejasny	vague
żmudny [2]	arduous; daunting
w najbliższej przyszłości	in the nearest future
w ciągu tygodnia	within a week
nielogiczny	illogical
zarysować coś	to scratch sth
związywać kogoś	to tie sb up
zeznania	a testimony
krzywoprzysięstwo	perjury
sprawca	a perpetrator
być poszukiwanym (przez policję)	to be wanted
skazywać kogoś	to convict sb
uniewinniać kogoś	to acquit sb
psycholog	a psychologist
wchodzić do pokoju	to enter the room
termostat	a thermostat
piec(do ogrzewania domu) [2]	a stove; a furnace
wymawiać słowo	to pronounce a word
wsiadać do pociągu	to get on the train
pozbywać się czegoś [2]	to get rid of sth; to ditch sth
wodować (awaryjnie)	to ditch
złomowisko	a junkyard
wysypisko	a dump
uciekać [2]	to run away; to flee
odkładać coś na później [2]	to postpone sth; to put sth off
odwoływać spotkanie [2]	to cancel a meeting; to call off a meeting
wychodzić z pokoju	to leave the room
wychodzić z domu	to leave the house
wchodzić do domu	to enter the house
węgiel	coal
wózek dla dziecka	a baby carriage
bazować na czymś	to be based on sth
popierać kogoś	to back sb up
wpadać na coś	to crash into sth
wysiadać z samochodu	to get out of the car
wsiadać do auta	to get in the car
wysiadać z pociągu	to get off the train
bagażnik	a trunk
kontynuować	to proceed
błotnik	a fender
zderzak	a bumper
gmina	a commune
rozpraszać kogoś	to distract sb
benzyna	gas(oline)
wynosić śmieci	to take out the garbage
z jednej strony	on one hand
społeczność	a community
wpadać w pułapkę	to get trapped
dźgać kogoś nożem	to stab sb with a knife
szpiegować kogoś	to spy on sb
porzucać niemowlę	to abandon a baby
zamarzać	to freeze
noworodek	a newborn
pomoc medyczna	medical attention
ławka	a bench
zbliżać się do czegoś	to approach sth
dzwonić po karetkę	to ring up for an ambulance
lekarz rodzinny	a GP
zgłaszać się	to come forward
wypłacać wygraną zwycięzcy	to pay out the prize money to the winner
rzekomo	allegedly
nagranie	footage
być wtrąconym do aresztu	to be taken into custody
być o coś oskarżonym	to be charged with sth
znaczna suma	a substantial sum
nagroda	a prize
nabyty zgodnie z prawem	lawfully acquired
nieodebrana nagroda	an unclaimed prize
ostatecznie (nie: finally; eventually)	ultimately
całkowicie niedostępny	utterly inaccessible
umierać z powodu komplikacji	to die from complications
szacować	to estimate
przekaz bankowy	a bank draft
tracić dostęp do	to lock myself out of sth
zjawisko	a phenomenon
mieć miejsce	to occur
pokrywać się z czymś	to coincide with sth
całkowite zaćmienie	a total eclipse
całe wydarzenie	an entire event
być świadkiem czegoś	to witness sth
częściowy	partial
stado alpak	a herd of alpacas
gromada zwierząt	a host of animals
dotrzymywać komuś towarzystwa	to keep sb company
specjalizować się w czymś	to specialize in sth
demencja	dementia
udana próba	a successful trial
emeryt	a pensioner
pobudzony	animated
rówieśnik	a peer
wraz z	alongside sth
polubić kogoś	to take to sb
uroczy	enchanting
pochylać się do przodu	to lean forward
opiekun	a carer
robić na kimś dobre pierwsze wrażenie	to be a hit with sb
gawędzić	to chat away
dostrzegać obiekt	to spot an object
unosić się	to float
odpalać rakietę	to launch a rocket
być na coś podatnym	to be susceptible to sth
na przykład (nie: example)	for instance
dalsza analiza	further analysis
przypominać coś	to resemble sth
stawać się niebieskim	to turn blue
nadmorska miejscowość	a seaside town
worek	a sack
rozrywać	to rupture
pożar	a fire
wybuchać (o wojnie lub pożarze)	to break out
niebezpieczny (nie: dangerous)	hazardous
gasnąć	to fade
kopać rów	to dig a trench
nieszkodliwy proszek	a harmless powder
tlić się	to smoulder
wzmacniać coś	to boost sth
plon	a yield
chłodny	cool
pozbawiać kogoś pracy	to put sb out of business
susza	a drought
sadzić	to plant
spadać o jeden procent	to fall by one percent
być dobrze do czegoś dopasowanym	to be well suited to sth
cierpieć z powodu niedoboru wody	to suffer a water shortage
szkodnik	a pest
kwiat (nie: flower)	a blossom
mróz	a frost
owoce	fruit
być ograniczonym do czegoś	to be limited to sth
zmagać się z ryzykiem	to face risk
poświęcić prywatność w zamian za wygodę	to forfeit privacy for convenience
być na bieżąco	to stay in the loop
zadawać pytanie (nie: ask)	to pose a question
zrzekać się prawa do czegoś	to waive the right to sth
magazyn ilustrowany	a glossy magazine
kapusta kiszona	sauerkraut
krzątanina	hustle
zapraszać kogoś do zrobienia czegoś	to invite sb to do sth
podejmować się nowej roli	to take on a new role
być czymś znudzonym	to be bored with sth
﻿beczka	a barrel
decydować się na coś	to decide on sth
czyjś asystent	an assistant to sb
być zaznajomionym z czymś	to be familiar with sth
być zadowolonym z czegoś	to be happy about sth
być dobrym kandydatem na coś	to be a good match for sth
wprowadzać produkt na rynek [2]	to launch a product; to roll out a product
robić zakupy spożywcze [2]	to do the grocery shopping; to do the food shopping
karp	a carp
brać prysznic	to take a shower
problemy psychiczne	mental issues
kłaść coś	to lay sth
popierać kogoś [2]	to support sb; to back sb up
popierać coś	to approve of sth
zastawa stołowa	dinnerware
mąka	flour
schabowy	a pork chop
bułka tarta	breadcrumbs
gęś	a goose
pączek	a donut
warsztat samochodowy	a garage
w warsztacie	at the garage
spędzać czas na robieniu czegoś	to spend time on doing sth
chory psychicznie	mentally ill
leżeć w łóżku	to lie in bed
kłamać kogoś	to lie to sb
burmistrz	a mayor
w pociągu	on the train
w autobusie	on the bus
w samolocie	on the plane
w samochodzie	in the car
wsiadać do samochodu	to get in the car
uwziąć się na kogoś	to pick on sb
całkiem nowy	brand new
zwracać koszty podróży	to reimburse travel expenses
mieć mało energii	to be low on energy
podlizywać się komuś	to suck up to sb
utknąć w korku	to get stuck in a traffic jam
pisać do kogoś	to text sb
dzwonić do kogoś	to call sb
oddzwaniać do kogoś [2]	to get back to sb; to call sb back
odpisywać komuś	to text sb back
parking	a parking lot
rata	an installment
kupować coś na raty	to buy sth on installments
zwrot wydatków	a reimbursement of expenses
być oderwanym od rzeczywistości	to be off base
przekonywać kogoś	to win sb over
wpajać komuś wartości	to instill values in sb
czuć się dobrze	to feel good
być czymś karmionym	to be fed with sth*
postanowienie noworoczne	a New Year's resolution
kura	a hen
kurczaczek	a chicken
kurczak	chicken
uczęszczać na kurs	to attend a course
robić zakupy	to do the shopping
zamieszanie	turmoil
pokonywać przeszkodę	to get over an obstacle
zmierzać tam	to head there
doprowadzać do czegoś	to lead to sth
zapewniać komuś schronienie	to provide shelter for sb
umożliwiać coś	to enable sth
powtórzenie	a review
ujawniać coś	to reveal sth
dotyczyć większości kraju	to extend to most of the country
powodować silną reakcję	to prompt a strong response
propan	propane
topić się	to drown
wydobywać coś	to mine sth
chudnąć	to lose weight
powierzchnia	a surface
opady śniegu	snowfall
podejmować kroki do zrobienia czegoś	to take measures to do sth
dobry samarytanin	a Good Samaritan
silny wiatr (nie: strong)	intense wind
powtarzać coś (not repeat)	to echo sth
odległy	distant
istotny	essential
rozprzestrzeniać z rośliny na roślinę	to spread from plant to plant
baza	a base
zakłócenie	a disruption
z dnia na dzień	overnight
próba zrobienia czegoś	an attempt to do sth
sztuczny	artificial
nieprzejezdny	impassible
rekordowy upał	a record-breaking heatwave
dostrzegać coś	to spot sth
To wskazuje, że...	It indicates that...
Naukowcy odkryli, że...	Researchers revealed that...
Z powodu zmiany...	Due to the change...
wichura	a gale
przenocowywać kogoś w hotelu	to put sb up in a hotel
spadać (nie: fall)	to plummet
zauważyć coś	to note sth
ryzyko (nie: danger)	a hazard
zagrażać czemuś	to threaten sth
łagodnie	gently
odwodniony	dehydrated
komentować coś	to comment on sth
sterylny	sterile
zauważalna zmiana	a noticeable difference
korzyść z czegoś	a benefit of sth
pojemnik	a receptacle
różne zadania (not different)	various tasks
przemycać coś	to smuggle coś
meteoryt	a meteorite
młode(u zwierzęcia)	a cub
porywisty wiatr	gusty wind
rozmnażać rośliny	to propagate plants
wśród	amid
ustępować (np. o burzy)	to subside
upalne warunki	scorching conditions
powódź	a flood
wzbudzać podejrzenia	to raise suspicions
przejadać się	to overeat
podmuch	a gust
resztka	a remnant
temperatura gwałtownie rosnąca ponad 40 stopni Celsjusza	a temperature soaring above 40C
oszacowywać coś	to estimate sth
zdolny do zrobienia czegoś	capable of doing sth
łączyć się	to merge together
powiadamiać kogoś	to notify sb
wybuch (np. epidemii)	an outbreak
wychodzić z uśpienia	to emerge from dormancy
lepszy (bardziej wskazany)	preferable
żwir	grit
istotne pożywienie	staple food
celnik	a customs officer
różnorodność czegoś	a variety of sth
gruby	thick
reszta czegoś	the rest of sth
przywiązywać coś do czegoś	to tie sth to sth
około	approximately
przewidywać zmianę	to predict a change
możliwy do podtrzymania	sustainable
okaz	a specimen
zdradziecki	treacherous
To zwykle jest... (nie: usually)	It tends to be...
Jak można było się spodziewać...	Unsurprisingly...
wymijająca odpowiedź	an evasive answer
meteor	a meteor
przerwa w dostawie prądu	a power cut
kępa kurzu	a clump of dust
przygasać (o świetle)	to dip
ostrożność	caution
hojny	generous
władze	authorities
odporny na chorobę	resistant to a disease
czaić się	to lurk
odłamek (pocisku)	a shrapnel
przenośny zbiornik	a portable tank
akcja o szerokim zasięgu	a widespread operation
uwaga (skupienie)	attentiveness
dokładność	accuracy
hodować rośliny	to breed plants
tracić życie	to lose one's life to sth
bursztynowy	amber
znosić coś	to endure sth
supermarkety na całym świecie	supermarkets worldwide
wyobrażać sobie coś (nie: imagine)	to envisage sth
rozkwit	a bloom
wydawać ostrzeżenie	to issue a warning
torbacz	a marsupial
postrzępiony	jagged
wysoka cena (nie: high)	a hefty price
zwracać się do kogoś (w celu uzyskania pomocy)	to reach out to sb
obniżać do czegoś	to downgrade to sth
ruda	an ore
osoba na diecie	a dieter
pożądany	sought-after
stawiać na czymś stopę	to set foot on sth
aukcja	an auction
ogólna jakość	the overall quality
obozowisko	an encampment
prymitywny	crude
zamykać się	to shut
niekorzystne warunki pogodowe	adverse weather conditions
dietetyk	a dietician
prowadzić badania (nie: research)	to lead a study
rozwijać coś	to brew sth up
poza wpływem (czegoś)	unaffected
ostry	severe
wyraźny kolor	a distinct color
podczas godzin szczytu	during rush hour
nieoczekiwany	unforeseen
odcień	a hue
odmiana grzyba	a fungal strain
ofiarowywać coś	to donate sth
prawdopodobnie	likely
lina	a rope
poskręcany	twisted
przyspieszać metabolizm	to rev up the metabolism
połączone wyniki (z różnych źródeł)	pooled results
rzecznik prasowy	a spokesperson
rzucać na coś światło	to shed light on sth
nakłaniać kogoś do zrobienia czegoś	to urge sb to do sth
obywatel	a citizen
polowanie na coś	a hunt for sth
iglica	a spire
uroczyście	solemnly
złamane serce	a heartbreak
pogodzić się z czymś	to come to terms with sth
wzruszający	poignant
spokojny	serene
straszny	dreadful
być w złym nastroju	to be in a bad mood
inwestować w coś pieniądze	to invest money in sth
osiągać cel (nie: achieve, reach) [2]	to hit a goal; to attain a goal
mieć zaufanie do kogoś	to have trust in sb
za dużo o czymś myśleć	to overthink sth
traktować coś priorytetowo	to prioritize sth
polegać na swojej intuicji	to rely on your guts
podlegać dyskusji	to be open for discussion
czekać w kolejce	to wait in line
złośliwy [2]	spiteful; catty
być w dobrym nastroju	to be in a good mood
inwestować (nie: invest)	to make an investment
brać kogoś za pewnik	to take sb for granted
popełniać błędy	to make mistakes
na ogół	in general
przechodzić do czegoś	to move on to sth
alternatywa (nie: alternative)	a backup option
w międzyczasie	in the meantime
główny priorytet	a top priority
bezpośredni podwładny	a direct report
popełniać błąd	to make a mistake
wspominać coś komuś	to mention sth to sb
tłumaczyć coś komuś	to explain sth to sb
opisywać coś komuś	to describe sth to sb
język ojczysty	a mother tongue
badać kogośe	to give sb a checkup
przechodzić badania kontrolne	to have a checkup
prorok	a prophet
przepowiednia	a prophecy
pewnego razu [2]	one day; once
huragan	a hurricane
mieć kaszel	to have a cough
mieć katar	to have a runny nose
mieć gorączkę	to have a fever
w szpitalu	at the hospital
badanie	an examination
badać kogoś	to examine sb
niebezpieczny [2]	dangerous; hazardous
narzekać na coś	to complain about sth
utknąć	to get stuck
głosić coś	to preach sth
powstawać z martwych	to rise from the dead
kończyć coś	to wrap sth up
Z jednej strony...	On one hand...
technicznie	technically
zaprzepaszczać okazję	to squander away an opportunity
w Stanach Zjednoczonych	in the US
kończyć projekt	to wrap up a project
zły na kogoś	angry with sb; mad at sb
Z drugiej strony...	On the other hand...
w porządku obrad	on the agenda
dane liczbowe	figures
kilka	a few
mało	few
włamywać się do domu	to break into a house
﻿zestresowany	stressed-out
stresujący	stressful
dzisiaj rano	this morning
nadążać za kimś	to keep up with sb
nadążać za nauczycielem	to keep up with the teacher
zalegać z pracą domową	to fall behind with homework
pozostawać w tyle z czymś	to fall behind with sth
dbać o klientów	to take care of clients
zajmować się czymś	to take care of sth
opiekować się kimś [2]	to take care of sb; to look after sb
ambitny	ambitious
pisać test	to take a test
podchodzić do egzaminu	to take an exam
ochraniać kogoś	to protect sb
wspominać o czymś	to mention sth
szpital psychiatryczny	a psychiatric hospital
psychiatra	a psychiatrist
psychopata	a psychopath
raport	a report
zasypiać	to fall asleep
przekładać spotkanie [2]	to postpone a meeting; to put off a meeting
robić komuś niespodziankę [2]	to make sb a surprise; to make a surprise for sb
kręcić się wokół czegoś	to revolve around sth
na stacji benzynowej	at the gas station
stacja benzynowa	a gas station
rozlewać kawę	to spill coffee
rozlewać coś	to spill sth
balon	a balloon
wysiadać z autobusu	to get off the bus
głaskać kota	to pet a cat
głaskać psa	to pet a dog
wsiadać do autobusu	to get on the bus
cofać się	to step back
wołać o pomoc	to cry for help
patyk	a stick
wykonany ze stali	made of steel
pręt [2]	a bar; a rod
kamień	a stone
skała	a rock
rzucać kamieniem	to throw a stone
wykonany z kamienia	made of stone
wykonany z drewna	made of wood
wykonany z metalu	made of metal
wykonany z tworzywa sztucznego	made of plastic
wykonany ze skóry	made of leather
wykonany z bawełny	made of cotton
wykonany z żelaza	made of iron
tracić przytomność	to lose consciousness
robić komuś badania kontrolne	to give sb a checkup
Jeśli chodzi o…	When it comes to…
przerywać komuś	to interrupt sb
nazwisko	a last name
policjant	a police officer
przebierać się za policjanta	to dress up as a police officer
W międzyczasie...	In the meantime...
monitoring	a surveillance camera
w rogu	in the corner
mieć miejsce (nie: take place)	to occur
mieć miejsce (nie: occur)	to take place
kończyć pracę (nie: finish)	to knock off
kończyć pracę (nie: knock)	to finish work
podejście [2]	an attitude; an approach
być w tym samym wieku	to be the same age
znajdować pracę	to find a job
wkładać w coś wysiłek	to put effort into sth
Ziemia	(the) Earth
odhaczać zadanie	to check off a task
semestr	a semester
ustalać granice	to establish boundaries
nawiązywać relację	to establish a relationship
zakładać rodzinę	to establish a family
montować coś	to fix sth
wydobywać czyjś talent	to bring out sb's talent
woleć coś robić	to prefer to do sth
znosić coś (wytrzymywać, nie: stand)	to bear sth
zapraszać kogoś do siebie	to have sb over
W drodze do domu...	On my way home...
introwertyczny	introverted
introwertyk	an introvert
ekstrawertyk	an extrovert
ekstrawertyczny	extroverted
gospodarz	a host
dbający o rodzinę	family-oriented
ciotka	an aunt
wujek	an uncle
zapraszać kogoś na spotkanie	to invite sb to a meeting
zapraszać kogoś na rozmowę kwalifikacyjną	to invite sb to a job interview
zapraszać kogoś na obiad	to invite sb to lunch
przejmować coś	to take sth over
rozpamiętywać coś	to dwell on sth
zastanawiać się nad czymś	to reflect on sth
po raz pierwszy	for the first time
pierwszy dzień	the first day
pierwszy odcinek	the first episode
pierwszy lot	the first flight
pierwsza klasa	the first grade
zwracać uwagę na czyjąś wymowę	to pay attention to sb's pronunciation
wymowa	pronunciation
całe słownictwo	all the vocabulary
czytać coś na głos	to read sth out loud
Chciałbym podkreślić, że ...	I'd like to stress that...
gorzej	worse
na tylnym siedzeniu	in the back seat
robić rentgen klatki piersiowej	to X-ray your chest
na nagraniu	in the footage
na obrazie	in the picture
wściec się	to get mad
brać ślub	to get married
zmęczyć się	to get tired
rozpraszać się	to get distracted
spijać się	to get drunk
trzymać się planu [2]	to follow a plan; to stick to a plan
trzymać się zasad	to stick to the rules
trzymać się tematu	to stick to the subject
trzymać się scenariusza	to stick to the script
trzymać się swojej historii	to stick to your story
dotrzymywać obietnicy	to stick to your promise
trzymać się swojej decyzji	to stick to the decision
popełniać przestępstwo	to commit a crime
popełniać samobójstwo	to commit suicide
popełniać morderstwo	to commit murder
przygotowywać się na coś	to get prepare for sth
przygotowywać się do egzaminu	to get prepared for an exam
przygotowywać się do pracy	to get prepared for work
słuchawki	earphones
odbierać dzieci ze szkoły	to pick up the kids from school
podrzucać dzieci do szkoły	to drop off the kids at school
uprzednio coś wyjaśniać	to explain sth upfront
jak najszybciej	as quickly as possible
rozmawiać przez telefon	to talk over the phone
Na szczycie tego...	On top of that...
wciągający [2]	involving; gripping
trzymający w napięciu	suspenseful
Norwegia	Norway
Skandynawia	Scandinavia
skarb	treasure
łup	the loot
klasztor	a monastery
mnich	a monk
zakonnica	a nun
jeniec	a captive
robić krok wstecz	to take a step back
nocą	overnight
nie doceniać czegoś	to underestimate sth
dodatkowa opłata	an additional fee
być na minusie	to be in the red
być na plusie	to be in the black
cieszyć się widokiem	to enjoy the view
cieszyć się pogodą	to enjoy the weather
cieszyć się czymś	to enjoy sth
pogrzeb	a funeral
koronacja	a coronation
czuwanie (przed pogrzebem)	a wake
poronienie	a miscarriage
świątynia	a temple
szablon	a template
składać bogom ofiarę	to make an offering to the gods
być dla kogoś dobrym rozwiązaniem	to be a good fit for sb
chrześcijanin	a Christian
katolik	a Catholic
w centrum handlowym	in the mall
spadać o 1%	to drop by 1%
wchodzić w życie [2]	to come into effect; to take effect
ogłszać nowe przepisy	to announce new regulations
zwalniać kogoś [2]	to dismiss sb; to lay sb off
To dlatego, że...	It's because...
koszulka	a T-shirt
koszula	a shirt
sukienka	a dress
dres	a tracksuit
kapelusz	a hat
szalik	a scarf
bluza	a sweatshirt
mundur	a uniform
sweter	a jumper
szorty	shorts
spódnica	a skirt
bielizna	underwear
kieszeń	a pocket
spodnie	pants
but	a shoe
płaszcz	a coat
rajstopy	tights
krawat	a tie
rękawica	a glove
kapcie	slippers
spodnie jeansowe	jeans
bluzka	a blouse
ubrania	clothes
skarpetka	a sock
czapka	a cap
garnitur	a suit
kurtka	a jacket
nadrabiać coś	to catch up with sth
w biurze	in the office
być przeciążonym pracą	to be overburdened with work
przemęczać się	to overextend yourself
prognoza pogody	a weather forecast
A co gorsza...	And what's worse...
słyszeć, jak ktoś coś robi	to hear sb doing sth
zauważyć, jak ktoś coś robi	to notice sb doing sth
patrzeć, jak ktoś coś robi	to watch sb doing sth
sojusznik	an ally
wróg	an enemy
powodować problemy	to cause trouble
słodzić kawę	to put sugar in your coffee
przekonujący	convincing
Jestem pewien, że...	I'm convinced that...
przekonywać kogoś do zrobienia czegoś	to convince sb to do sth
przekonujący (nie: convincing)	compelling
gubić coś	to lose sth
otwierać drzwi (nie: open)	to unlock the door
odblokowywać telefon	to unlock the phone
iść do pracy	to go to work
widzieć, jak ktoś coś robi	to see sb doing sth
samowystarczalny	self-sufficient
zakładać coś	to put sth on
mieć wgląd w coś	to have insight in sth
cierpliwość	patience
niecierpliwy	impatient
cierpliwy	patient
pomijać [2]	to skip; to ommit; to leave out
w przeszłości	in the past
samemu [2]	on my own; by myself
cecha osobowości	a personality trait
być nękanym	to be harassed
odpowiadać czyimś wymaganiom	to live up to sb's expectations
wydajność	efficiency
wydajny	efficient
pozywać kogoś	to sue sb
pozew sądowy	a lawsuit
przede wszystkim	in the first place
w pierwszej klasie	in the first grade
w pierwszym sezonie	in the first season
mieć temperaturę	to have a temperature
przyjeżdżać do hotelu	to arrive at the hotel
przyjeżdżać do Warszawy	to arrive in Warsaw
przybywać na komisariat	to arrive at the police station
przyjeźdżać do Polski	to arrive in Poland
przyjeżdżać do szpitala	to arrive at the hospital
przybywać do pracy	to arrive at work
puszka [2]	a can; a tin
jeść pizzę	to eat a pizza
kwadrat	a square
losowy	random
losowo	randomly
przyjeżdżać do domu	to arrive home
przybywać na miejsce	to arrive at the scene
niedużo wiedzieć na na jakiś temat	to have little knowledge of sth
mieć dużą wiedzę z czegoś	to have a wide knowledge of sth
dobrze przygotowany	well-prepared
dobrze zorganizowany	well-organized
bronić kogoś	to defend sb
﻿obrona	a defense
chrzcić kogoś	to baptize sb
chrzest	baptism
przyjmować chrzest	to be baptized
zrobić na kogoś obławę	to round sb up
obława	a roundup
żenić się z kimś	to get married to sb
paryski	Parisian
śledzić kogoś	to follow sb
pościg	a chase
gonić kogoś	to chase (after) sb
jaskinia	a cave
czuć się samotnie	to feel lonely
samotny	lonely
wpadać na obiad	to come over for dinner
iść do toalety	to go to the restroom
iść do łóżka	to go to bed
﻿iść na kolację	to go to dinner
iść do szkoły	to go to school
iść na uczelnię	to go to university
iść do więzienia [2]	to go to jail; to go to prison
iść do kościoła	to go to church
jechać na lotnisko	to go to the airport
iść na plażę	to go to the beach
iść do kina	to go to the movies
iść do parku	to go to the park
iść na basen	to go to the swimming pool
iść do łazienki	to go to the bathroom
iść do kuchni	to go to the kitchen
iść do sypialni	to go to the bedroom
iść do salonu	to go to the living room
iść do sklepu	to go to the store
iść do banku	to go to the bank
jechać nad jezioro	to go to the lake
iść do restauracji	to go to a restaurant
iść na imprezę	to go to a party
iść na spotkanie	to go to a meeting
iść na koncert	to go to a concert
iść na konferencję	to go to a conference
iść do baru	to go to a bar
iść na festiwal	to go to a festival
jechać na przejażdżkę	to go for a ride
iść biegać [2]	to go for a run; to go running
iść na spacer	to go for a walk
iść na kawę	to go for a coffee
iść na drinka	to go for a drink
jechać na wakacje	to go on vacation
iść na zwolnienie	to go on sick leave
iść strajkować	to go on strike
wychodzić na scenę	to go on stage
przechodzić na dietę	to go on a diet
jechać na wycieczkę	to go on a trip
wyruszać na wyprawę	to go on an adventure
iść do domu	to go home
jechać za granicę	to go abroad
iść potańczyć	to go dancing
iść na zakupy	to go shopping
jechać do centrum	to go downtown
iść na piwo	to go for a beer
spontaniczny	spontaneous
spontaniczność	spontaneity
spontanicznie	spontanously
dobrze się bawić	to have fun
nabijać się z kogoś	to make fun of sb
wyśmiewać coś	to make fun of sth
przechodzić na angielski	to switch to English
przechodzić na polski	to switch to Polish
użyteczny	useful
bezużyteczny	useless
czepianie się szczegółów	nit-picking
szukać dziury w całym	to nitpick
kończyć zadanie	to complete a task
kończyć kurs	to complete a course
dzielić coś na coś	to divide sth into sth
zarażać się	to get infected
być na coś otwartym	to be open to sb
odwrotnie	the other way round
nawiązywać z kimś kontakt	to get in touch with sb
ambitna praca	an ambitious job
40 metrów kwadratowych	40 squaremeters
sprzymierzać się z kimś [2]	to ally with sb; to ally to sb
wieża	a tower
przekraczać rzekę	to cross the river
przechodzić przez ulicę	to cross the street
korzystać z czegoś	to take advantage of sth
wykorzystywać kogoś	to take advantage of sb
domyślne ustawienia	default settings
wykonywać transplantację [2]	to perform a transplantation; to perform a transplant
dawać coś komuś [2]	to give sb sth; to give sth to sb
zastępować kogoś [2]	to substitute for sb; to fill in for sb
robić rzeczy	to do things
być lojalnym wobec kogoś	to be loyal to sb
spadać ze schodów	to fall down the stairs
wypadać przez barierkę	to fall over the railing
balustrada	a railing
wyrzucić kogoś przez barierkę	to throw sb over the railing
wyrzucać coś do śmieci	to throw sth into the garbage
w ogóle	at all
zakładać się z kimś	to make a bet with sb
przegrywać zakład	to lose a bet
wygrywać zakład	to win a bet
stawiać coś na kogoś	to bet sth on sth
poświęcać coś (rezygnować z czegoś)	to sacrifice sth
rzucać pracę	to give up a job
rezygnować z robienia czegoś	to give up doing sth
rzucać taniec	to give up dancing
rzucać palenie	to give up smoking
rzucać narkotyki	to give up drugs
skreślać słowo	to strike a word
tracić nad czymś kontrolę	to lose control over sth
powstrzymywać kogoś przed zrobieniem czegoś	to prevent sb from doing sth
powstrzymać kogoś od czegoś	to prevent sb from sth
podkreśliać coś	to stress sth
nad morzem	at the sea
butla z gazem	a propane tank
wstydzić się czegoś	to be ashamed of sth
udzielać komuś pozwolenia	to give sb permission
iść w dobrym kierunku	to go in the right direction
iść w złym kierunku	to go in the wrong direction
poznawać kogoś lepiej	to get to know sb better
skazywać kogoś na śmierć	to sentence sb to death
zostać skazanym na śmierć	to be sentenced to death
wykrwawiać się na śmierć	to bleed to death
kara śmierci	the death penalty
liczba ofiar śmiertelnych	the death toll
być świadkiem czegoś [2]	a witness to sth; to witness sth
panować	to reign
Dzięki temu...	Thanks to that...
Dzięki Tobie...	Thanks to you...
sprawiać, że ktoś coś robi	to make sb do sth
zgłaszać się na ochotnika	to volunteer
W ciągu tych dni...	During those days...
osiągać porozumienie	to reach agreement
przybyć na stacji kolejowej	to arrive at the train station
przybyć na impreze	to arrive at the party
przybyć do banku	to arrive at the bank
przybyć do mojego przyjaciela	to arrive at my friend's
przybyć na spotkanie	to arrive at the meeting
przybyć do szkoły	to arrive at school
brać coś pod uwagę	to take sth into consideration
pandemia	a pandemic
poświęcać się czemuś	to be dedicated to sth
odpowiadać na e-maile	to reply to emails
odpowiadać na wiadomości	to reply to messages
odpowiadać komuś [2]	to reply to sb; to respond to sb; to answer sb
jechać na zachód	to go west
szkodzić swojej reputacji	to damage my reputation
pozbywać się czegoś	to get rid of sth
w więzieniu [2]	in prison; in jail
zapraszać kogoś na coś	to invite sb to sth
zapraszać kogoś na kawę	to invite sb for a coffee
zapraszać kogoś na kolację	to invite sb to dinner
sąsiedni kraj	a neighboring country
nowo przybyły	a new arrival
nowo przybyły [2]	a newcomer; an new arrival
kropka	a period
cudzysłów	a quotation mark
w cudzysłowie	in quotation marks
nawias kwadratowy	a square bracket
dwukropek	a colon
średnik	a semicolon
wielokropek	an ellipsis
myślnik	a dash
ukośnik	a slash
wykrzyknik	an exclamation mark
nawias	a parenthesis
przecinek	a comma
znak zapytania	a question mark
w nawiasach	in parentheses
łącznik	a hyphen
spadek	an inheritance
zostawiać komuś spadek	to leave sb an inheritance
dziedziczyć coś	to inherit sth
dokonywać przelewu	to make a transfer
pogrubioną czcionką	in bold
dziura	a hole
głosować na kogoś	to vote for sb
głosować przeciw komuś	to vote against sb
podejrzany (osoba)	a suspect
podejrzewać kogoś	to suspect sb
podejrzewać kogoś o coś	to suspect sb of sth
osoba o podobnym nastawieniu	a like-minded person
odwiedzać kogoś	to visit sb
wracać późno do domu	to come back home late
psuć komórkę	to break a cell phone
rozmawiać z kimś	to talk to sb
wyjeżdżać	to leave
zostawać w domu	to stay at home
nie mieć nic do roboty	to have nothing to do
płacić rachunki	to pay the bills
pomagać komuś	to help sb
być pewnym, że...	to be sure that...
spędzać z kimś czas	to spend time with sb
mierzyć komuś temperaturę	to take sb's temperature
źle się czuć (o zdrowiu)	to feel unwell
w poprzedniej pracy	in the previous job
w poprzednim odcinku	in the previous episode
być powściągliwym	to be reserved
odbierać kogoś ze szkoły	to pick sb up from school
spać u mojej koleżanki	to sleep at my friend's
jeść na mieście	to eat out
wydawać na coś pieniądze	to spend money on sth
być w domu	to be at home
być cicho	to be silent
robić pracę domową	to do your homework
nie mieć pieniędzy	to have no money
znajdować czas dla kogoś	to find time for sb
być dla kogoś ważnym	to be important to sb
skupiać się na czymś	to focus on sth
być głośno	to be loud
grać mecz	to play a match
dołączać do kogoś	to join sb
oszczędzać pieniądze	to save some money
dawać komuś znać	to let sb know
iść wcześnie spać	to go to sleep early
robić prezentację	to give a presentation
tęsknić za domem	to feel homesick
raz	once
wyjeżdżać z miasta	to leave town
uczyć się na test	to study for a test
zabierać kogoś do domu	to take sb home
jeść kolację	to eat dinner
oglądać mecz	to watch a match
wpadać (do kogoś)	to drop by
w weekend	on the weekend
Co powiesz na...	What about...
wkładać coś do szuflady	to put sth in the drawer
wkładać coś do zamrażarki	to put sth in the freezer
wkładać coś do bagażnika	to put sth in the trunk
wkładać coś do kieszeni	to put sth in your pocket
chodnik	a sidewalk
geodeta	a land surveyor
ratusz	a town hall
wystawiać fakturę [2]	to issue an invoice; to make out an invoice
księgować fakturę	to book an invoice
faktura	an invoice
Dlatego...	That's why...
w ciszy	in silence
jak już	once
na miejscu	in the place
rozwiązywać problem (nie: solve)	to tackle a problem
elektryk	an electrician
wywierać na kimś presję	to put pressure on sb
pamiętnik	a diary
harmonogram	a schedule
iść do wojska	to go to the army
iść na północ	to go north
iść na wschód	to go east
iść na południe	to go south
iść do szpitala	to go to the hospital
być zrobionym	to be done
uczyć się do egzaminu	to study for an exam
poznawać kogoś	to meet sb
przeziębiać się	to catch a cold
bać się czegoś	to be afraid of sth
przeprowadzać się	to move
znajdować nową pracę	to find a new job
mieć energię	to have energy
pić kawę	to have some coffee
prosić o podwyżkę	to ask for a pay-raise
być z powrotem w biurze	to be back in the office
widzieć kogoś	to see sb
być podekscytowanym	to be excited
nie móc się doczekać	can't wait
zaczynać kurs angielskiego	to start an English course
być gotowym	to be ready
przegrywać sprawę	to lose a case
przez ciebie	because of you
błąd	a mistake
odkładać spotkanie	to put off a meeting
dziać się	to happen
być pewnym	to be sure
podchodzić do testu z angielskiego	to take an English test
pamiętać coś	to remember sth
w tamtym tygodniu	last week
mieć nadzieję	to hope
żona	a wife
mówić komuś prawdę	to tell sb the truth
wydawać pieniądze na ubrania	to spend money on clothes
nadal	still
pić	to drink
na imprezie	at the party
późno	late
pogoda	the weather
kończyć coś robić	to finish doing sth
w moim rodzinnym mieście	in my hometown
spędzić następny weekend	to spend next weekend
kancelaria	a law firm
robić wrażenie	to make an impression
imponować komuś	to impress sb
kończyć dziennikarstwo	to graduate in journalism
kończyć studia	to graduate from university
kończyć liceum	to graduate from high school
kończyć studia prawnicze	to graduate in law
kończyć informatykę	to graduate in IT
główny bohater	the main character
główny problem	the main problem
główny powód	the main reason
główny zespół	the main team
danie główne	the main course
na główne danie	for the main course
zapobiegać rozprzestrzenianiu się wirusa	to prevent the virus from spreading
chodzić z kimś	to date sb
bać się o coś	to be afraid about sth
bać się pytań	to be afraid of questions
bać się o kogoś	to be afraid about sb
bać się kogoś	to be afraid of sb
(czyjaś) dziewczyna	a girlfriend
(czyjś) chłopak	a boyfriend
ambitny plan	an ambitious plan
mieć dużo pracy	to have a lot of work
na spotkaniu	at the meeting
wspominać coś	to mention sth
przyjeźdżać do Warszawy (nie: arrive)	to come to Warsaw
być niegrzecznym wobec kogoś	to be rude to sb
opowiadać komuś kawał	to tell sb a joke
dzisiaj	today
spędzać czas z kimś	to spend time with sb
﻿w zeszły weekend	last weekend
rodzina	a family
opowiadać komuś historię	to tell sb a story
być prywatnym	to be private
zostawiać napiwek	to leave a tip
klient	a customer
okłamywać kogoś	to lie to sb
wymówka	an excuse
znajdować wymówkę	to make an excuse
mieć wymówkę	to have an excuse
oddawać coś	to give sth back
nieruchomość	a property
robić bałagan	to make a mess
być głodnym	to be hungry
jeść śniadanie	to eat breakfast
szybko biegać	to run fast
zdążać na pociąg	to catch the train
prowadzić	to drive
bać się	to be afraid
mieć wypadek	to have an accident
trzymać się planu	to stick to the plan
w następnym tygodniu	next week
pracować	to work
jutro	tomorrow
zaprzyjaźniać się	to make friends
w zespole	on the team
jechać nad morze	to go to the seaside
być naćpanym [2]	to be high
kończyć w sądzie	to end up in court
trafiać do więzienia	to end up in jail
trafiać do szpitala	to end up in the hospital
kończyć gdzieś	to end up swh
kończyć na ulicy	to end up on the street
kończyć w łóżku	to end up in bed
wylądować u mnie	to end up at my place
kończyć, robiąc coś	to end up doing sth
kłaść dziecko spać	to put a kid to sleep
wiele razy	many times
iść z kimś na imprezę	to go to a party with sb
składać obietnicę	to make a promise
być kimś rozczarowanym	to be disappointed with sth
łamać obietnicę	to break a promise
ufać komuś	to trust sb
przez długi czas	for a long time
rozmawiać o czymś	to talk about sth
przeprowadzać się na wieś	to move to the countryside
czytać książkę	to read a book
do końca roku	by the end of the year
ostatni	last
szukać pracy	to look for a job
oferta	an offer
zdążać na ostatni pociąg	to catch the last train
płuco	a lung
ustawiać alarm	to set an alarm
ustawiać budzik na 6	to set an alarm for 6 am
meduza	a jellyfish
sesja zdjęciowa [2]	a photo session; a photo shoot
robić zdjęcie czegoś	to take a picture of sth
robić komuś zdjęcie	to take a picture of sb
mieć na coś negatywny wpływ	to have a negative influence on sth
literówka	a typo
w mieście [2]	in the city; in town
odwiedzać miejsce	to visit a place
w tym roku	this year
mieć czas	to have time
potrzeba	a need
spieszyć się	to hurry up
nie zdążać na pociąg	to miss the train
zachowywać się	to behave
w ten sposób	like that
rozmawiać z kimś przez telefon	<div>to talk to sb over the phone</div>
pamiętać	to remember
dziś wieczorem	tonight
dostawać pracę	to get a job
reszta twojego życia	the rest of your life
godny zaufania	trustworthy
wprowadzać w błąd	to be confusing
być zakłopotanym	to be confused
cytować kogoś [2]	to quote sb; to cite sb
cytat	a quote
traktować kogoś	to treat sb
dobrze kogoś traktować	to treat sb well
leczyć chorobę	to treat a disease
leczyć pacjenta	to treat a patient
być zdolnym do czegoś	to be capable of sth
być zdolnym do zrobienia czegoś	to be capable of doing sth
być zdolny do wszystkiego	to be capable of everything
3-miesięczne wypowiedzenie	a 3-month notice
być w kontakcie	to be in touch
mieć czegoś dość	to be fed up with sth
pracować nad projektem	to work on a project
ostrzegać kogoś, że...	to warn sb that...
Ostrzegałem cię, że...	I've warned you that...
wypadek	an accident
na autostradzie	on the highway
wychodzić na miasto	to go out
przeprowadzać się do Warszawy	to move to Warsaw
w następnym miesiącu	next month
czuć się zawiedzionym	to feel disappointed
pracować jako kelnerka	to work as a waitress
w liceum	in high school
W pewnym momencie...	At some point...
wracać do siebie (w związku)	to get back together
problem [2]	a problem; an issue
rozmawiać o kimś	to talk about sb
zostawiać coś	to leave sth
wpadać w poślizg	to go into a skid
jechać prosto	to go straight ahead
śliska droga	a slippery road
kosmetyczka	a beautician
zwalniać pedał hamulca	to release the brake pedal
zwalniać pedał gazu	to release the  accelerator pedal
być anonimowym	to be anonymous
na papierze	on paper
patrzeć na coś	to look at sth
być znudzonym	to be bored
być w mieście	to be in town
obiecywać coś komuś [2]	to promise sb sth; to promise sth to sb
układać włosy	to do your hair
śmiać się z kogoś	to laugh at sb
mieć kaca	to have a hangover
znaczyć coś	to mean sth
brać coś do siebie	to take sth personally
do lata	until summer
spierać się z kimś	to argue with sb
mieć sens	to make sense
mówić dobrze po angielsku	to speak English well
być rozbawionym	to be amused
być zabawnym (nie: funny)	to be amusing
lojalność	loyalty
wysyłać komuś wiadomość [2]	to send sb a message; to send a message to sb
wysyłać komuś mejla [2]	to send sb an email; to send an email to sb
wysyłać komuś list [2]	to send sb a letter; to send a letter to sb
wysyłać coś komuś [2]	to send sb sth; to send sth to sb
odkładać coś na następny tydzień	to put sth off until next week
przekładać spotkanie na jutro [2]	to postpone a meeting until tomorrow; to put off a meeting until tomorrow
na początku czegoś	at the beginning of sth
na początku kursu	at the beginning of the course
na początku gry	at the beginning of the game
na początku filmu	at the beginning of the movie
na początku roku	at the beginning of the year
na początku sezonu	at the beginning of the season
na początku odcinka	at the beginning of the episode
na początku historii	at the beginning of the story
na początku roku szkolnego	at the beginning of the school year
na początku spotkania	at the beginning of the meeting
na początku lekcji	at the beginning of the lesson
miliard	a billion
popisywać się	to show off
możliwość	a possibility
zwalniać kogoś	to fire sb
tyć	to gain weight
zbyt mało jeść	to eat too little
nauczyć się czegoś na test	to study sth for the test
mieć rację	to be right
obiecywać	to promise
być zaskoczonym	to be in shock
zauważać coś	to notice sth
na koncie	in the bank account
pieniądze	money
zasada	a rule
wyjaśniać sytuację	to explain the situation
jeden z moich klientów	one of my clients
pozbywać się kogoś	to get rid of sb
sprawiać problemy	to make trouble
w mieszkaniu	in the apartment
pokój	a room
czytać o czymś	to read about sth
pojawiać się na spotkaniu	to show up at the meeting
być w kawiarni	to be at the coffee shop
teraz	now
w tym miesiącu	this month
być dobrym w czymś	to be good at sth
być w czymś świetnym	to be great at sth
mieć czas, żeby coś zrobić	to have time to do sth
znajdywać rozwiązanie	to find a solution
trzymać coś w tajemnicy [2]	to keep sth a secret; to hold sth back
uczestnik	a participant
spotkanie	a meeting
mieć do czegoś słabość	to have a weakness for sth
jeść z kimś obiad (nie: eat)	to have lunch with sb
szef	a boss
dostawać pożyczkę (nie: get, receive, obtain)	to be granted a loan
być w stanie coś zrobić	to be able to do sth
prowadzić badanie (nie: lead)	to conduct a study
wreszcie	finally
pić herbatę (nie: drink)	to have tea
często	often
sąsiad	a neighbor
lubić kogoś	to like sb
pierwotny plan	the initial plan
wymykać się spod kontroli	to get out of control
rozumieć kogoś	to understand sb
być złym na kogoś	to be mad at sb
docierać na spotkanie	to get to a meeting
na czas	on time
mówić prawdę	to tell the truth
gratulacje	congratulations
słyszeć wieści	to hear the news
polityka	politics
nowo zatrudniona osoba (nie: person)	a new hire
windykator	a debt collector
mierzyć się z problemem	to face a problem
stawić czemuś czoła	to face sth
rozwodzić się z kimś	to divorce sb
iść późno spać	to go to sleep late
szukać kogoś	to look for sb
głos przeciwko komuś	a vote against sb
kandydat	a candidate
opuszczać budynek	to leave the building
robić test ciążowy	to do a pregnancy test
test ciążowy	a pregnancy test
agencja nieruchomości	a real estate agency
dowiadywać się, że...	to find out that...
rodzić się	to be born
dziecko	a kid
podróżować	to travel
mąż	a husband
być w związku małżeńskim	to be married
dowiadywać się czegoś	to find sth out
kilka tygodni temu	a few weeks ago
mieć właśnie coś zrobić	to be about to do sth
pojawiać się	to show up
zostawać dłużej w pracy	to stay at work longer
niepotrzebne rzeczy	unnecessary things
życie	a life
zmieniać się	to change
zostać zwolnionym	to get fired
być zmęczonym	to be tired
być ciągle zmęczonym	to be constantly tired
ćwiczyć (na siłowni)	to work out
być w formie	to be in shape
być zainteresowanym tematem	to be interested in a subject
prasa	the press
pisać o czymś	to write about sth
przeważnie	mostly
opowiadać o czymś	to tell about sth
problem	a problem
nieznajomy	a stranger
pluć na kogoś	to spit at sb
﻿komar	a mosquito
wyrażenie	a phrase
na zaawansowanym poziomie	at the advanced level
po twojej stronie	on your end
CV	a resume
oszustwo	fraud
oszust	a fraud
wygłaszać przemówienie	to give a speech
dawać wykład	to give a lecture
iść na ugodę	to settle
zawierać ugodę w danej sprawie	to settle a case
osada	a settlement
być skazanym na rok więzienia	to be sentenced to a year in jail
pierwszego dnia	on the first day
pierwsze wrażenie	the first impression
pierwsza osoba, która wyszła	the first person to leave
pierwszy projekt	the first project
pierwszy semestr	the first semester
pierwszy krok	the first step
pierwsza podróż	the first trip
pierwszy rok	the first year
pierwszy sezon	the first season
być pierwszym w kolejce	to be the first in line
siedzieć w pierwszym rzędzie	to sit in the first row
na pierwszej randce	on the first date
robić pierwszy krok	to take the first step
telefon komórkowy	a cell phone
ulegać czemuś [2]	to surrender to sth; to give in to sth
okazywać się dobrą osobą	to turn out to be a good person
okazywać się oszustem	to turn out to be a cheater
okazywać się kłamcą	to turn out to be a liar
strażnik	a guard
mścić się na kimś	to take revenge on sb
dręczyć kogoś	to put sb upon the rack
robić zupę	to make soup
rzygać	to throw up
ulepszać coś	to improve sth
być skutecznym	to be efficient
uczyć się czegoś (nie: learn)	to study sth
wesele	a wedding party
kilka dni (nie: a few)	a couple of days
Chociaż... (nie: although)	Even though...
znajomy	a friend
niebezpieczny pies	a dangerous dog
być zapominalskim	to be forgetful
cała drużyna	the whole team
otwierać nową filię	to open a new branch
filia	a branch
robić się zajętym	to get busy
parkować swój samochód	to park your car
być daleko od czegoś	to be far away from sth
centrum handlowe	a mall
jeździć na rowerze	to ride a bike
zdawać sobie sprawę, że...	to realize that...
przejechać znak stop	to run a stop sign
mieć z czymś problem	to have a problem with sth
restauracja	a restaurant
uspokajać kogoś	to calm sb down
brać udział w czymś	to take part in sth
brać udział w maratonie	to take part in a marathon
nieodpowiednie pytanie	an unappropriate question
mieć wyrzuty sumienia	to have remorse
szczepić kogoś na coś	to vaccinate sb for sth
szczepionka na coś	vaccine for sth
zostać zaszczepionym	to get vaccinated
płacić grzywnę	to pay a fine
grzywna	a fine
być dobrze zorganizowanym	to be well-organized
być dobrze wyposażym	to be well-equipped
być dobrze zbudowanym	to be well-built
respirator	a respirator
zajmować się kimś (nie: take, look)	to attend to sb
przyjmować kogoś do szpitala	to admit sb to the hospital
epidemia	an epidemic
wybuch epidemii	an epidemic outbreak
sprzedawca	a shop assistant
być na linii frontu	to be in the front line
przyzwyczajać się do robienia czegoś	to get used to doing sth
przyzwyczajać się do sytuacji	to get used to the situation
coś kogoś obchodzi	to care about sth
dbać o opinię innych osób	to care about others' opinion
kwalifikować się do czegoś	to be eligible for sth
kwalifikować się do ubezpieczenia	to be eligible for insurance
wymyślać coś	to come up with sth
być wytrwałym	to be persistent
udowadniać swoje racje	to prove your point
dowodzić czegoś	to prove sth
przypominać coś komuś [2]	to remind sb sth; to remind sth to sb
czuć ulgę	to feel relieved
być wdzięcznym	to be grateful
ostrzegać kogoś o czymś	to warn sb about sth
dostawać grzywnę	to get a fine
zostać zaskoczonym	to get surprised
wyprowadzać się	to move out
trzymać się od czegoś z dala	to stay away from sth
kontynent	a continent
głód	hunger
na świecie	in the world
walczyć o coś	to fight for sth
środek do zmiękczania tkanin	fabric softener
﻿być na zwolnieniu lekarskim	to be on sick leave
osoba fizyczna (nie: person)	an individual
stosować się do zasad	to comply with the rules
lekarz (nie: doctor)	a physician
nie mieć umiejętności	to lack skills
nie mieć wiedzy na jakiś temat (nie: have)	to lack knowledge of sth
nie mieć czegoś (nie: have)	to lack sth
korporacja	a corporation
na pokładzie	on board
kara śmierci (nie: death)	capital punishment
zgadzać się na coś	to agree to sth
podejmować ryzyko	to take risk
wynajmować mieszkanie	to rent an apartment
własny dom	my own house
kupować dom	to buy a house
uśmiechać się do kogoś	to smile at sb
przemyśleć coś	to think sth over
być humorzastym	to be moody
siedzieć przed telewizorem	to sit in front of the TV
codziennie	every day
robić kolację	to make dinner
brać pożyczkę	to take out a loan
żyć w ubóstwie	to live in poverty
zaręczać się	to get engaged
wygrywać sprawę	to win a case
swędzieć	to be itchy
mieć prawo zachować milczenie	to have the right to remain silent
pozostawać	to remain
pozostawać otwartym	to remain open
otrzymywać [2]	to get sth; to receive sth; to obtain sth
wystarczające wsparcie	sufficient support
dalsze badania	further research
robić dalsze badania	to do further research
potrzebować dodatkowych informacji	to need further information
potrzebować dodatkowych szczegółów	to need further details
mieć wystarczające oszczędności	to have sufficient savings
statystyka	statistics
wzrost czegoś	an increase in sth
wzrost sprzedaży	an increase in sales
powodować wzrost czegoś	to cause an increase in sth
brać prysznic [2]	to take a shower; to have a shower
być upoważnionym, żeby coś zrobić	to be authorized to do sth
paszport	a passport
Polacy	the Polish
Brytyjczycy	the British
płacić podatek	to pay a tax
potrzebować czyjejś porady	to need sb's advice
Ostatni raz, kiedy rozmawialiśmy...	The last time we talked...
mówić coś	to say sth
być żywym	to be alive
Kiedy ostatnim razem...	When was the last time...
włączać światła (w samochodzie)	to turn on the headlights
zatrzymywać kogoś (o drogówce)	to pull sb over
policja	the police
palić coś	to burn sth
twoje rzeczy	your stuff
za chwilę	in a moment
parkować samochód	to park a car
przed budynkiem	in front of the building
możliwość zrobienia czegoś	a possibility to do sth
fakt	a fact
zrywać	to break up
brać udział w konkursie [2]	to take part in a competition; to take part in a contest
konkurs [2]	a competition; a contest
podejmować kroki, aby coś zrobić	to take measures to do sth
iść na emeryturę	to retire
być na emeryturze	to be retired
znajdować swoje powołanie	to find your vocation
mieć ubezpieczenie	to have insurance
płacić za coś	to pay for sth
kupować nowy samochód	to buy a new car
należeć do kogoś	to belong to sb
decydować, że...	to decide that...
mieszkać za granicą	to live abroad
sprzątać pokój	to clean up my room
mama	a mom
sklep (nie: shop)	a store
wychodzić ze sklepu	to leave a store
więzienie [2]	a jail; a prison
osadzony	an inmate
obecnie	currently
dostawać skurczu	to get a cramp
topić się	to drown
nagle	suddenly
w łazience	in the bathroom
dawać komuś podwyżkę	to give sb a pay-raise
być zwolnionym	to be fired
Niestety...	Unfortunately...
mieć coś przeciwko	to mind
wyrażać swoją opinię	to express your opinion
informować kogoś	to inform sb
polegać na kimś	to rely on sb
produkt	a product
dostępny (na magazynie)	in stock
brać łapówkę	to take a bribe
tracić prawo jazdy	to lose your driver's license
jeździć po pijaku	to drive drunk
tracić panowanie nad sobą	to lose your temper
mieć kłopoty	to be in trouble
tracić pracę	to lose your job
wykonywać telefon	to make a call
wiedzieć coś	to know sth
książka o czymś	a book about sth
zachowywać się podejrzanie	to behave suspiciously
aresztować kogoś	to arrest sb
tańczyć z kimś	to dance with sb
przepraszać (nie: apologize)	to be sorry
Chciałbym...	I'd like to...
potwierdzać spotkanie	to confirm a meeting
mieć stały dochód	to have a steady income
nie mieć nic przeciwko czemuś	to have nothing against sth
rodzic	a parent
związek	a relationship
wygrywać zawody	to win a competition
odpowiadać na wiadomość	to reply to a message
docierać do domu	to get home
woleć coś od czegoś	to favor sth over sth
woleć kogoś od kogoś	to favor sb over sb
być prezycyjnym	to be precise
zasoby finansowe	financial resources
utrzymywać rodzinę	to provide for your family
utrzymywać kogoś	to provide for sb
obracać się przeciwko komuś	to backfire on sb
robić sobie drzemkę	to take a nap
marzyć o czymś	to dream of sth
pić wodę z kranu	to drink tap water
opcja	an option
mieć szlaban	to be grounded
zdawać sobie z czegoś sprawę	to realize sth
oszukiwać kogoś	to cheat sb
zapominać coś zrobić	to forget to do sth
rezerwować stolik	to book a table
jeść kolację [2]	to eat dinner; to have dinner
w restauracji	at the restaurant
mieć zamiar coś zrobić	to be going to do sth
zajście	an incident
niania	a nanny
zastępować coś czymś	to replace sth with sth
siedzieć w ostatnim rzędzie	to sit in the last row
ostatni odcinek	the last episode
ostatni sezon	the last season
ostatni raz	for the last time
w pierwszym odcinku	in the first episode
przy pierwszej okazji	at the first opportunity
uciekać od czegoś	to escape from sth
ocalić kogoś od czegoś	to save sb from sth
otrzymywać zniżkę	to get a discount
kupować meble	to buy furniture
zamykać drzwi (na klucz)	to lock the door
mieć dowody	to have evidence
wierzyć komuś	to believe sb
okradać kogoś	to rob sb
w pobliżu	nearby
bankomat	an ATM
zakładać czapkę	to put on a cap
być czymś podekscytowanym	to be thrilled about sth
u moich rodziców	at my parents'
przystanek autobusowy	a bus stop
wybór	a choice
brać dzień wolnego	to take a day off
mieć dzień wolny	to have a day off
wietnamski	Vietnamese
wyprowadzać się od rodziców	to move out of your parents' house
jeść coś na obiad	to eat sth for lunch
dostawać stypendium	to get a scholarship
mieć dobre stopnie	to have good grades
artykuł o czymś	an article on sth
ciągle coś robić	to keep doing sth
jeść szybko	to eat quickly
mieć ból brzucha	to have a stomachache
pies	a dog
pisać o czymś artykuł	to write an article about sth
być drażliwym	to be touchy
czekać na coś	to wait for sth
próg	a threshold
uzgadniać coś	to agree on sth
broń	a weapon
posiadać broń	to possess a weapon
zamierzać coś zrobić	to intend to do sth
wymagający nauczyciel	a demanding teacher
pijawka	a leech
odzywać się	to speak up
dobijać targu	to close a deal
zależeć od czegoś	to depend on sth
dostawać premię	to get a bonus
wolontariusz	a volunteer
zrywać z kimś	to break up with sb
spać	to sleep
wypijać filiżankę kawy	to drink a cup of coffee
tracić swoje oszczędności	to lose your savings
przyznawać, że...	to admit that...
zwracać produkt	to return a product
zabierać się do pracy	to get down to work
spóźniać się do pracy	to be late for work
zajmować się dziećmi	to take care of the kids
jeść obiad [2]	to eat lunch; to have lunch
robić obiad	to make lunch
w temacie	on the subject
rozwijać myśl na temat czegoś	to elaborate on sth
wyprzedać samochód	to overtake a car
oblewać egzamin na prawo jazdy	to fail a driving test
rzucać palenie (nie: stop, give up)	to quit smoking
być zdrowym	to be healthy
na uniwersytecie	at the university
piec ciasto	to bake a cake
Dzięki za coś...	Thanks for sth
impreza urodzinowa	a birthday party
zadzwonić (o budziku)	to go off {2}
zasypiać do pracy	to oversleep for work
alarm	an alarm
być w formie [2]	to be fit; to be in shape
zaczynać uprawiać sport	to take up a sport
rzecznik policji	a police spokesperson
potwierdzać coś	to confirm sth
złodziej	a thief
pracować nad czymś	to work on sth
wyrażać wdzięczność	to express your gratitude
z powołania	by vocation
na rowerze	on the bike
w deszczu	in the rain
w wodzie	in the water
na ścianie	on the wall
na stronie dziesiątej	at the page 10
w kinie	at the movies
w helikopterze	in the helicopter
w ogrodzie	in the garden
na lekcji	in class
u fryzjera	at the hairdresser’s
w hotelu	at the hotel
na statku	on the ship
w rzece	in the river
w windzie	in the elevator
w domu	at home
w taksówce	in the taxi
na stadionie	at the stadium
na lotnisku	at the airport
na niebie	in the sky
w łóżku	in bed
w klubie	at the club
w kuchni	in the kitchen
na wybrzeżu	on the coast
u lekarza	at the doctor's
w gazecie	in a newspaper
po prawej	on the right
na uczelni	at university
na półce	on the shelf
w łódce	in the boat
w drodze	on the way
z tyłu samochodu	in the back of the car
w telewizji	on TV
na ulicy	on the street
na rogu	at the corner
w szkole	at school
w kolejce	in line
w pudełku	in the box
na suficie	on the ceiling
na ślubie	at the wedding
w Warszawie	in Warsaw
na dywanie	on the carpet
po lewej	on the left
w mieście	in town
w menu	on the menu
w parku	at the park
na biurku	on my desk
przy wejściu	at the entrance
u mojego znajomego	at my friend's
w portfelu	in my wallet
na farmie	on the farm
w pokoju	in the room
na stole	on the table
przy biurku	at the desk
na drzwiach	on the door
na podłodze	on the floor
w rogu pokoju	in the corner of the room
na środku ogrodu	in the middle of the garden
w korku	in a traffic jam
na krześle	in the chair
w książce	in the book
na górze strony	at the top of the page
w banku	at the bank
na końcu drogi	at the end of the road
w koszu	in the bin
na wsi	in the country
w radiu	on the radio
w teatrze	at the theater
w kieszeni	in my pocket
na skrzyżowaniu dwóch ulic	at the intersection of two streets
w więzieniu	in prison
w sypialni	in the bedroom
na dole strony	at the bottom of the page
w lustrze	in the mirror
przy drzwiach	at the door
przed szkołą	in front of the school
na końcu odcinka	at the end of the episode
w Polsce	in Poland
na przystanku	at the bus stop
w budynku	in the building
w łazience (na mieście)	in the restroom
jechać do szpitala	to go to the hospital
3. listopada	on November 3 (third)
w następny poniedziałek	next Monday
1. września	on September 1 (first)
w tym tygodniu	this week
w ten czwartek	this Thursday
wiosną	in spring
latem	in summer
w każdą środę	every Wednesday
w zeszły piątek	last Friday
na jesieni	in fall
w każdy poniedziałek	every Monday
co drugi dzień	every other day
rano	in the morning
w następny wtorek	next Tuesday
w maju	in May
w lipcu	in July
w zeszłym roku	last year
w listopadzie	in November
we wtorek	on Tuesday
w zeszły wtorek	last Tuesday
w zeszły czwartek	last Thursday
w styczniu	in January
w poniedziałek	on Monday
w tę niedzielę	this Sunday
w tygodniu	in the week
tamtego dnia	on that day
w południe	at noon
w każdą niedzielę	every Sunday
w niedzielę	on Sunday
w piątek	on Friday
w każdą sobotę	every Saturday
w zeszłą środę	last Wednesday
2. października	on October 2 (second)
w każdy czwartek	every Thursday
w przyszłą niedzielę	next Sunday
co tydzień	every week
wieczorem	in the evening
w tą sobotę	this Saturday
w lutym	in February
w marcu	in March
w kwietniu	in April
zimą	in winter
w nocy [2]	at night; in the night
w ten poniedziałek	this Monday
co miesiąc	every month
w sobotę	on Saturday
co wtorek	every Tuesday
co piątek	every Friday
co rok	every year
w środę	on Wednesday
o 15	at 3 pm
w grudniu	in December
w zeszły poniedziałek	last Monday
w następny czwartek	next Thursday
w czwartek	on Thursday
w czerwcu	in June
w ten wtorek	this Tuesday
4. grudnia	on December 4 (fourth)
popołudniu	in the afternoon
za dnia	by day
w 2019 roku	in 2019
w zeszłym miesiącu	last month
w następną sobotę	next Saturday
w następny piątek	next Friday
w przyszłym roku	next year
w zeszłą niedziela	last Sunday
w zeszłą sobotę	last Saturday
w tę środę	this Wednesday
w październiku	in October
w 2020 roku	in 2020
we wrześniu	in September
w sierpniu	in August
płaca minimalna	the minimum wage
właśnie	just {2}
już	already
pochwalać coś	to approve of sth
detektyw	a detective
podczas przesłuchania (świadka)	during questioning
widzieć coś	to see sth
na obiad	for lunch
gasić pożar	to put out the fire
wzywać służby ratownicze	to call the emergency services
natychmiast coś robić	to immediately do sth
dotrzymywać obietnic	to keep your promises
mówić płynnie po angielsku	to speak English fluently
przeprowadzać się za granicę	to move abroad
zgadzać się z kimś	to agree with sb
być świadomym czegoś	to be aware of sth
pewne fakty	certain facts
siedzieć w więzieniu [2]	to do time; to serve a sentence
odwoływać się od decyzji sądu	to appeal the court's decision
żądać, żeby...	to demand that...
oddalać sprawę	to dismiss a case
doprowadzać kogoś do szleństwa	to drive sb crazy
być wrakiem	to be a wreck
brać narkotyki (nie: take, dope)	to do drugs
przez ostatni rok	for the past year
wstawać wcześnie	to get up early
dbać o środowisko	to take care of the environment
środowisko	the environment
na co dzień	on a daily basis
gatunek	a species
wyginąć	to die out
zamawiać frytki	to order French fries
być pełnym	to be full
premier	the prime minister
ustępować ze stanowiska	to step down
prezes	the president {2}
zostać pociągniętym do odpowiedzialności	to be held responsible
czytać między wierszami	to read between the lines
dostawać mandat	to get a ticket
przekraczać dozwoloną prędkość	to be speeding
dawać komuś informację zwrotną	to give sb feedback
robić śniadanie	to make breakfast
pasażer	a passenger
kierowca	a driver
ostro hamować	to slam on the brakes
wyciągać pochopne wnioski na jakiś temat	to jump to conclusions about sth
być na czymś skupionym	to be focused on sth
rozmowa	a conversation
z wyprzedzeniem rezerwować bilety	to book tickets in advance
podsłuchiwać rozmowę [2]	to eavesdrop on a conversation; to listen in on a conversation
podejmować odpowiednie kroki	to take appropriate steps
podejmować kroki	to take steps
skopać komuś tyłek	to kick sb's ass
rozpowiadać plotki	to spread gossip
ostatnio	the other day
śmiać się z czegoś	to laugh at sth
brać kogoś na poważnie	to take sb seriously
od czasu do czasu	from time to time
być rozpieszczonym	to be spoiled
dawać komuś dobry przykład	to set a good example for sb
kończyć studia na kierunku finanse	to graduate in Finance
kończyć ekonomię	to graduate in Economics
kończyć studia na jakimś kierunku	to graduate in sth
aresztować kogoś za coś	to arrest sb for sth
zwracać komuś pieniądze	to refund sb's money
mieć niską samoocenę	to have low self-esteem
być dręczonym	to be bullied
znęcać się nad kimś	to bully sb
jako nastolatek	as a teenager
zeznawać w sądzie	to testify in court
szantażować kogoś	to blackmail sb
czekać na kogoś	to wait for sb
twój kolega	a friend of yours
mój kolega	a friend of mine
być w czymś beznadziejnym	to be terrible at sth
podrywać kobiety	to pick up women
być oburzonym	to be outraged
ostrzegać kogoś przed czymś [2]	to warn sb about sb; to warn sb of sb
zapominać	to forget
być słabym z czegoś	to be bad at sth
słuchać innych	to listen to others
zarząd	the management board
przekraczać budżet	to go over budget
Byłbym wdzięczny, gdyby...	I'd be grateful if...
robić komuś przysługę	to do sb a favor
dyrektor szkoły	the school principal
Zastanawiałem się, czy...	I was wondering if...
jakiś czas temu	a while ago
wybaczać komuś	to forgive sb
próbować coś zrobić	to try to do sh
przekupywać kogoś	to bribe sb
wygrywać z kimś	to win against sb
podsłuchiwać rozmowę	to eavesdrop on a conversation; to listen in on a conversation
chować urazę do kogoś	to hold a grudge against sb
ośmieszać kogoś	to ridicule sb
na oczach swoich przyjaciół	in front of your friends
sprzątać swoje mieszkanie	to clean your apartment
właściciel firmy	the company's owner
być przepracowanym	to be overworked
odpoczywać	to take a rest
w weekendy	on weekends
właściciel (wynajmujący mieszkanie)	a landlord
składa się z dwóch części	to consist of two parts
projekt	a project
cierpieć na coś	to suffer from sth
profesor	a professor
pisać wypracowanie	to write an essay
Gdyby tylko...	I wish that...; If only...
korek	a traffic jam
w twoim imieniu	on your behalf
w różnym tempie	at a different pace
przerwa	a break
planować przerwę (nie: plan)	to schedule a break
hamulec	a brake
nauczyciel	a teacher
przeprowadzać się do innego miasta	to move to a different city
linia montażowa	the assembly line
dostarczać towary	to deliver the goods
mieć problem z zasypianiem	to have trouble falling asleep
odpakowywać prezent	to unwrap a gift
narzędzie	a tool
być zrobionym ze stali nierdzewnej	to be made of stainless steel
rdzewieć	to get rusty
przepraszać kogoś za coś	to apologize to sb for sth
być czymś zmęczonym	to be tired of sth
robić z kimś interesy	to do business with sb
żyć blisko kogoś	to live close to sb
być sprawiedliwym (nie: fair)	to be just
zbierać wiedzę o czymś	to gather knowledge of sth
spać z kimś	to sleep with sb
przechowywać swoje dane w chmurze	to store your data in the cloud
przywracać dane	to restore data
znać prawdę	to know the truth
odnosić się do czegoś	to refer to sth
artykuł	an article
być możliwym	to be possible
sugerować, że...	to suggest that...
wychodzić wcześniej	to leave earlier
osoba bezrobotna	an unemployed person
być bezrobotnym	to be unemployed
w naszym miasteczku	in our town
fabryka	a factory
zostawać zamkniętym	to shut down
niedawno	recently
zakładać własną firmę	to set up your own company
zakładać swoją własną firmę	to set up my own company
dorastać	to grow up
iść na uniwersytet	to go to college
operować kogoś	to operate on sb
wystawiać fakturę	to issue an invoice
na swoim kocie bankowym	in your bank account
lekarz	a doctor
badać pacjenta	to examine a patient
firma	a company
być przyjaznym dla środowiska	to be environment-friendly
przeprowadzać badania na zwierzętach	to conduct tests on animals
wyglądać dobrze	to look good
być wartym obejrzenia	to be worth watching
być wartym robienia czegoś	to be worth doing sth
wygrywać nagrodę	to win a prize
jak dotąd	so far
zespół	a team
mieć zły sen	to have a bad dream
gotować	to cook
uczyć kogoś, jak coś robić	to teach sb how to do sth
mieć ból pleców	to have back pain
ryzykować utratą pracy	to risk your job
siedzieć w domu	to sit at home
zapominać coś	to forget sth
męskie spodenki kąpielowe	swim trunks
prowadzić swoją własną firmę	to run your own company
mieć problem	to have a problem
być ciekawym	to be curious
tracić swój czas	to waste your time
na zewnątrz	outside
leżeć na plaży	to lie on the beach
odwoływać lot	to cancel a flight
dobrze się bawić (nie: fun)	to have a good time
być podejrzanym o coś	to be suspected of sth
dokonywać kradzieży	to commit theft
być spłukanym	to be broke
imprezować	to party
dojeżdżać do pracy	to commute to work
mieszkać w mieście	to live in the city
ćwiczyć	to exercise
zapisywać się na zajęcia z jogi	to sign up for yoga classes
uczyć się angielskiego	to learn English
dawać komuś zastrzyk	to give sb an injection
trząść się	to tremble
dostać zatrucia pokarmowego	to get food poisoning
czuć się źle	to feel bad
wyrzucać swoje ubrania	to throw away your clothes
oddawać coś na cele charytatywne	to give sth to charity
mieć odrę	to have measles
mieć wysypkę	to have a rash
mieć lekcję angielskiego	to have an English class
uderzać kogoś w twarz	to punch sb in the face
prowokować kogoś	to provoke sb
mówić coś komuś	to tell sb sth
ścielić łóżko	to make the bed
denerwować się na kogoś	to get mad at sb
słuchać muzyki	to listen to music
w tym samym czasie	at the same time
konserwant	a preservative
zwrot z inwestycji	a return on investment
nieskuteczna metoda	an ineffective method
oceniać coś	to assess sth
jeść słodycze	to eat candy
mieć problemy z sercem	to have heart problems
kilka razy w ciągu dnia	a few times a day
płacić podatki	to pay your taxes
spać spokojnie	to sleep peacefully
spojrzeć na coś	to take a look at sth
jeszcze raz	once again
zerkać na dokument	to take a look at a document
wyrzucać coś	to throw sth out
wyglądać przez okno	to look out the window
palić papierosa	to smoke a cigarette
biegać ulicą	to run down the street
bezpański pies	a stray dog
uprawiać seks	to have sex
słyszeć kogoś	to hear sb
być dobrym nauczycielem	to make a good teacher
sylaba	a syllable
Od teraz...	From now on...
raz w tygodniu	once a week
omawiać coś	to discuss sth
wątpić w coś	to doubt sth
składać wniosek	to file an application
podpisywać podanie	to sign an application
mieć potrzebne umiejętności	to have the necessary skills
wykonywać pracę	to do a job
pracować z ludźmi	to work with people
oszczędzać wodę	to save water
obniżać rachunki	to lower your bills
w nocy	at night
oczekiwać, że ktoś coś zrobi	to expect sb to do sth
zaczynać coś robić [2]	to start to do sth; to start doing sth
palić	to smoke
być pod presją rówieśników	to be under peer pressure
aplikować na stanowisko	to apply for a position
czytać maile	to read emails
karabin	a rifle
pisać coś (na komputerze lub telefonie)	to type sth
przeprowadzać test	to carry out a test
mieć problem z czymś	to have trouble doing sth
mieć problemy ze snem	to have trouble sleeping
mieć kłopoty z oddychaniem	to have trouble breathing
bez problemu	without a problem
oglądać horror	to watch a horror
mieć rozmowę o pracę	to have a job interview
rekruter	a recruiter
mieć grypę	to have the flu
pomagać komuś coś robić	to help sb do sth
kłócić się	to have an argument
być upartym	to be stubborn
dawać koncert	to give a concert
za tydzień	in a week
sączyć drinka	to sip a drink
wydawać pieniądze na niepotrzebne rzeczy	to spend money on unnecessary things
decydować się	to make up your mind
żyć	to live
podobny przypadek	a similar case
czuć się bezpiecznie	to feel safe
pobierać próbki krwi	to take blood samples
badać próbki	to examine samples
nie mieć na kogoś żadnego wpływu	to have no influence on sb
sytuacja	a situation
mieć dostęp do pliku	to have access to a file
sprawdzać coś	to check sth
pobijać szkolny rekord	to beat the school record
pobijać rekord	to beat the record
wspierać kogoś	to support sb
mieć prawo coś zrobić	to have the right to do sth
przeglądać czyjś telefon	to look through sb's phone
zupa	soup
wkładać coś do lodówki	to put sth in the fridge
psuć się (o jedzeniu) (nie: off)	to go bad
buty	shoes
pasować na kogoś	to fit sb
włączać muzykę	to turn on the music
spać (nie: sleep)	to be asleep
zamieniać z kimś słowo	to have a word with sb
robić się podejrzliwym	to get suspicious
być blisko z kimś	to be close to sb
być pokornym	to be humble
rozkładać coś na części	to take sth apart
nowożeńcy	newly married
raz na jakiś czas	once in a while
nudzić się czymś	to get bored with sth
iść źle	to go wrong
martwić się	to worry
jedzenie	food
gość	a guest
być dobrze poinformowanym	to be well-informed
oglądać wiadomości	to watch the news
robić coś regularnie	to do sth regularly
ściągać na sprawdzianie	to cheat on the test
płakać	to cry
rozstanie	a breakup
Na szczęście...	Fortunately...
mieć udar	to have a stroke
mdleć	to faint
brać tabletki	to take pills
rozmawiać	to talk
mieć szansę, aby coś zrobić	to have the chance to do sth
przepraszać kogoś	to apologize to sb
troszczyć się o kogoś	to take care of sb
rozsiewać o kimś plotki	to spread rumors about sb
wchodzić do pokoju (nie: enter)	to come into the room
zwiększać swoją produktywność	to increase your productivity
w ostatnim kwartale	last quarter
bankrutować	to go bankrupt
mieć przerwę	to have a break
w końcu coś robić	to finally do sth
kontaktować się z klientem	to contact a client
dać radę coś zrobić	to manage to do sth
mieć spotkanie	to have a meeting
oglądać kreskówki	to watch cartoons
cały czas	all the time
pielgrzymka	a pilgrimage
pielgrzym	a pilgrim
papież	Pope
ksiądz	a priest
chór	a choir
w czyimś imieniu	on behalf of sb
podróż	a journey
na całym świecie	across the world
w całym mieście	across the city
w całej organizacji	across the organization
w całej firmie	across the company
pracować na pełen etat	to work full-time
pracować na część etatu	to work part-time
mieć ból gardła	to have a sore throat
załatwiać sprawy (nie: run)	to do errands
mieć nad czym popracować	to have room for improvement
W porównaniu do ciebie...	Compared to you...
W porównaniu do mnie...	Compared to me...
W porównaniu do...	Compared to...
mieć szczęście	to be lucky
być zadowolonym z czegoś (nie: satisfied)	to be happy about sth
cieszyć się czyimś szczęściem	to be happy for sb
być niebezpiecznym	to be dangerous
mieć wpływ na kogoś	to have influence on sb
przyciągać czyjąś uwagę	to attract sb's attention
być przekonującym	to be convincing
satysfakcjonująca oferta	a satisfying offer
park rozrywki	a theme park
radzić sobie z czymś	to deal with sth
podnosić śmieci	to pick up rubbish
kruk	a crow
zapełniać czymś wiadro	to fill a bucket with sth
zostawać w tyle	to lag
być naturalnym	to be natural
martwić się o coś	to be worried about sth
mieć raka	to have cancer
płacić za leczenie	to pay for treatment
przekazać coś na cele charytatywne	to donate sth to charity
zbierać na coś pieniądze	to raise money for sth
zbierać pieniądze	to raise money
w twojej pracy	in your job
siniak	a bruise
rozsądne rozwiązanie	a reasonable solution
grupa wsparcia	a support group
wylądować u ciebie	to end up at your place
poważne badania	a major study
zmniejszać coś (nie: reduce)	to lower sth
rezultat	findings
prowadzić do czegoś	to lead to sth
problem ze zdrowiem psychicznym	a mental health problem
nalegać na robienie czegoś	to insist on doing sth
uzależnienie od czegoś	an addiction to sth
nadużywanie	an overuse
rodzinne więzi	family bonds
długowieczność	longevity
wzniecać coś	to spark sth
grawerować coś	to engrave sth
prawdziwy przyjaciel	a genuine friend
napotkanie	an encounter
cytować coś	to quote sth
akademik	a dorm
narzeczony	a fiance
kłamstwo	a lie
krewny	a relative
być zawiedzionym	to be disappointed
w wypadku samochodowym	in a car accident
Okazało się że…	It turned out that...
być przerażonym	to be terrified
sprzedawać coś	to sell sth
wypłacać pieniądze	to withdraw money
aluminium	aluminum
stan zdrowia psychicznego	a mental health condition
niezawodność	reliability
zazdrość	envy
kumpel	a buddy
przywilej	a privilege
zanikać	to atrophy
małżonek	a spouse
przysłowie	a proverb
interesować się czymś (nie: interested, into)	to be keen on sth
głodować	to starve
zyskać szybką popularność (w Internecie)	to go viral
filmować coś	to film sth
foka	a seal
film dokumentalny	a documentary
przez kilka następnych dni	for the next few days
być zafascynowanym czymś	to be fascinated about sth
pawian	a baboon
ekscentryczna osoba (nie: eccentric)	a quirky person
być bezbronnym	to be vulnerable
samokontrola	self-control
zażyła relacja	an intimate relationship
występek	a misdeed
być wybrednym	to be picky
zamieniać się w coś (nie: change, turn)	to devolve into sth
wybredna osoba	a picky person
zaraźliwe emocje	contagious emotions
czuć się zaniepokojonym	to feel dismayed
czuć się rozczarowanym (nie: disappointed)	to feel disillusioned
czerpać coś	to derive sth
być nieuniknionym	to be inevitable
mit	a myth
bezwarunkowa miłość	unconditional love
nadmierna presja	undue pressure
pojęcie	a notion
lubić coś (nie: like)	to be fond of sth
być fantastycznym (nie: fantastic)	to be fabulous
czuć się niedowartościowanym	to feel inadequate
być gderliwym	to be cranky
składać skargę	to make a complaint
być męczącym	to be tiring
mieć kontakt z kimś	to have contact with sb
mieć kontakt z ludźmi	to have contact with people
ciągnąć się (o spotkaniu)	to drag on
w naszej firmie	in our company
rozwiązanie czegoś	a solution to sth
wciskać kogoś w grafik	to fit sb in to the schedule
płacić komuś	to pay sb
wchodzić do biura	to enter the office
zastępować kogoś	to cover for sb
podejmować się zadania	to take on a task
zmyślać historyjkę	to make up a story
wybuchać (o epidemii)	to break out
zalegać z rachunkami	to fall behind with the bills
iść biegać	to go running
wytropić złodzieja	to track down a thief
zawodzić kogoś	to let sb down
poruszać temat	to bring up a subject
zauważać, że...	to notice that...
schrzaniać zadanie	to screw up a task
podejmować się projektu	to take on a project
rozważać opcje	to weigh up the options
działać	to act
zapinać pasy	to fasten up
podsumowywać spotkanie	to wrap up a meeting
przeglądać dokumenty	to go through documents
przeprowadzać badania (nie: do)	to carry out research
kryć kogoś	to cover up for sb
wyładowywać się	to vent
nadrabiać pracę domową	to catch up on your homework
mieć coś wspólnego	to have sth in common
mieć z kimś coś wspólnego	to have sth in common with sb
wyróżniać się	to stand out
stresujące doświadczenie	a nerve-wracking experience
zatrudniać kogoś	to hire sb
dokonanie	an accomplishment
brzmieć znajomo	to sound familiar
branża	an industry
odpowiadać z pewnością siebie	to answer with confidence
środowisko pracy	a work environment
odcisk palca	a fingerprint
być obrażonym	to be offended
być szkodliwym dla zdrowia	to be harmful to health
być nieszkodliwym	to be harmless
być samolubnym	to be selfish
poważnym tonem	in a serious tone
pracować nad czymś przez kilka dni	to work on sth for days
przystępować teraz do działania	to act now
działać w oparciu o coś	to act on sth
działać razem	to act together
być kimś zainteresowanym (nie: interested, into)	to be attracted to sb
twój najlepszy przyjaciel	your best friend
nosić sukienkę	to wear a dress
rozważać czynniki	to weigh up factors
podejmować decyzję	to make a decision
wybuchać (o bombie)	to go off
budzić się	to wake up
słyszeć coś	to hear sth
narzekać na swoją pracę	to complain about your job
ograniczać palenie	to cut down on smoking
bronić swoich zasad	to stand up for your principles
odwoływać spotkanie	to call off a meeting
pozbywać się formalności	to do away with formalities
oszczędzać czas	to save time
dawać komuś kosza	to turn sb down
być w toksycznym związku	to be in a toxic relationship
skarżyć na kogoś	to tell on sb
wyluzować się	to chill out
robić coś źle	to do sth wrong
drukować coś	to print sth out
prosić kogoś o coś	to ask sb for sth
dokument	a document
rezygnować z pracy	to give up the job
przypominać komuś coś	to remind sb of sth
wygłupiać się	to mess around
traktować kogoś poważnie	to treat sb seriously
podłapać amerykański akcent	to pick up the American accent
wracać ze Stanów	to come back from the US
przeglądać dokumentacje	to go through documentation
wiercić się	to fidget
pacjent	a patient
robić coś z nudów	to do sth out of boredom
zwracać uwagę na coś	to pay attention to sth
zwracać uwagę	to pay attention
dług	a debt
pokonywać przeszkody	to get over obstacles
radzić sobie z problemem	to get over a problem
przeboleć coś	to get over sth
przezwyciężać chorobę	to get over an illness
być w czymś spójnym	to be consistent in sth
podnosić poprzeczkę	to raise the bar
mieszać coś	to mix sth up
zwracać się do kogoś po pomoc	to turn to sb for help
przebierać się	to dress up
dostawać się na imprezę	to get to a party
zagadywać do dziewczyny	to chat up a girl
przezwyciężać trudność	to get over a difficulty
być skoncentrowanym na czymś	to concentrate on sth
chcieć, żeby ktoś coś zrobił	to want sb to do sth
zamiast czegoś	instead of sth
po prostu coś robić	to do sth simply
patrzeć na kogoś z góry	to look down on sb
młodszy brat	a younger brother
pić coś do końca	to drink sth up
Za każdym razem, gdy...	Every time...
być obserwowanym	to be watched
przebrnąć przez papierkową robotę	to go through paperwork
sekretarka	a secretary
kierownik	a manager
być bombardowanym informacjami	to be bombarded with information
być skomplikowanym	to be complicated
zmniejszać znaczenie czegoś	to play down the significance of sth
Szkoda, że...	It's a shame that...
wysiłek	an effort
być spóźnionym	to be late
rozglądać się	to look around
asystent	an assistant
potrzebować pomocy	to need help
strona	a page
być zaginionym	to be missing
być pesymistycznym	to be pessimistic
odświeżać się	to freshen up
czuć się lepiej	to feel better
trening	a workout
Mimo że...	Although...
nienawidzić papierkowej roboty	to hate paperwork
iść do więzienia	to go to jail; to go to prison
u twojego znajomego	at your friend's
u ciebie	at your place
być śpiącym	to be sleepy
być niecierpliwym	to be impatient
zrozumiałe wypowiedź	an understandable statement
zwalać winę na kogoś	to put the blame on sb
zalegać z czynszem	to fall behind with the rent
mieć problemy finansowe	to have financial problems
inni	others
być w pobliżu	to be around
wykonywać zadanie (nie: do, accomplish, complete)	to carry out a task
schrzanić coś	to screw sth up
schrzaniać prezentację	to screw up a presentation
podwyżka	a pay-raise
spotkanie zespołu	a team meeting
gromadzić się	to pile up
zauważać błąd	to notice a mistake
przeglądać dane	to go through data
Zauważyłem, że...	I've noticed that...
wytropić przestępcę	to track down a criminal
rzucać szkołę	to drop out of school
zaczynać zajmować się polityką	to go into politics
wystawiać rachunek	to make out a bill
proponować pomysł	to put forward an idea
zaproszenie na ślub	an invitation to a wedding
odrzucać zaproszenie	to turn down an invitation
były mąż	an ex-husband
słuchać czyjejś rady	to listen to sb's advice
słuchać swoich rodziców	to listen to your parents
słuchać starszych	to listen to the elders
słuchać podcastu	to listen to a podcast
słuchać wykładu	to listen to a lecture
słuchać wywiadu	to listen to an interview
słuchać piosenki	to listen to a song
słuchać playlisty	to listen to a playlist
słuchać rozmowy	to listen to a conversation
słuchać radia	to listen to the radio
słuchać swojego serca	to listen to your heart
słuchać czyjegoś głosu	to listen to sb's voice
słuchać ptaków	to listen to birds
słuchać audiobooka	to listen to an audiobook
słuchać swojego nauczyciela	to listen to your teacher
słuchać swojej intuicji	to listen to your intuition
słuchać swojego ciała	to listen to your body
słuchać swojego przeczucia	to listen to your gut
serial	a TV series
oglądać serial	to watch a TV series
nie okazywać zainteresowania czymś	to show no interest in sth
tracić zainteresowanie czymś	to lose interest in sth
obwiniać kogoś o coś	to blame sb for sth
uwodzić kogoś	to seduce sb
wyskakiwać (o powiadomieniu)	to pop up
być podatnym na coś (nie: susceptible)	to be prone to sth
przemoc	violence
nie mieć empatii	to lack empathy
wpływać na kogoś	to influence sb; to affect sb
być energicznym	to be energetic
natknąć się na coś	to come across sth
sprawdzać coś (nie: check, try)	to look into sth
analizować raport	to look into a report
przeprowadzać dochodzenie	to carry out an investigation
robić coś poprawnie	to do sth properly
podgrzewać jedzenie	to heat up the food
wkurzać kogoś	to piss sb off
praca (zadanie)	an assignment
gasić papierosa	to put out a cigarette
zapisywać coś [2]	to write sth down; to take sth down
rezygnować z czegoś	to resign from sth
znosić kogoś	to put up with sb
ostatnim razem	last time
detonować bombę	to let off a bomb
zatrzymywać kogoś (nie: pull over)	to stop sb
kilka razy	a few times
wykańczać kogoś (o stresie)	to wear sb down
przestawać mówić	to stop talking
czytać dalej	to keep reading
umawiać się z kimś (na randkę)	to ask sb out
koleś	a guy
przechodzić przez procedurę	to go through a procedure
odrzucać ofertę	to turn down an offer
inhalacja	inhalation
mieć wiele wspólnego	to have a lot in common
poznawać się lepiej	to get to know each other better
od czasu do czasu (nie: time)	every now and then
parę razy	a couple of times
być czyimś mężem (lub żoną)	to be married to sb
być z kimś w kontakcie	to be in touch with sb
posiadać psa (nie: possess)	to own a dog
posiadać coś (nie: possess)	to own sth
przyjeżdżać na miejsce zbrodni	to come to a crime scene
właściciel sklepu	a store owner
syn	a son
rzucać studia	to drop out of college
uwydatniać smak	to bring out the flavor
danie	a dish
przyprawy	spices
zadawać głupie pytania	to ask stupid questions
wykład	a lecture
startować (o samolocie)	to take off
pojawiać się na lotnisku	to show up at the airport
uzależniać się	to fall into addiction
przynosić sukces	to bring about success
zmiana	a change
drukować wypracowanie	to print out an essay
nakładać krem	to put on cream
zapominać o kimś	to get over sb
były	an ex
odrzucać wniosek	to turn down an application
zajmować miejsce (o przedmiocie)	to take up space
godzić się z kimś	to make up with sb
odjeżdżać (nie: away)	to drive off
dalej czytać książkę	to keep on reading a book
nadrabiać stracony czas	to make up for lost time
oddzwaniać do kogoś	to call sb back
kontaktować się z kimś	to contact sb
dyskryminować kogoś	to discriminate against sb
na pierwszym piętrze	on the second floor
na parterze	on the first floor
składać coś (montować)	to put sth together
być cennym	to be valuable
składać komuś wizytę	to pay sb a visit
na Nextfliksie	on Nextflix
obchodzić żałobę	to mourn
laboratorium	a lab
uczeń	a student
przeprowadzać eksperyment	to carry out an experiment
zagadywać do kogoś	to chat sb up
pracownik	an employee
fałszywa faktura	a fake invoice
kąpać się	to take a bath
wrzucać na luz	to wind down
przechodzić przez formalności	to go through formalities
wyglądać młodo	to look young
sprawdzać coś w internecie	to look sth up on the internet
przyjmować rolę	to take on a role
zdzierać z kogoś	to rip sb off
odpuszczać	to let go
ludzie	people
setki klientów	hundreds of clients
bank	a bank
rozpoczynać zajęcia taneczne	to take up dance classes
być zamieszanym w coś	to be mixed up in sth
spać u twojej koleżanki	to sleep at your friend's
wzrastać o jeden procent	to grow by one percent
być żałosnym	to be pathetic
świrować na punkcie czegoś	to freak out about sth
być łagodnym wobec kogoś	to be easy on sb
być ostrym wobec kogoś	to be hard on sb
zawozić kogoś do domu	to take sb home
utknąć w biurze	to get stuck in the office
przygotowywać się do prezentacji	to get prepared for a presentation
uzgadniać coś z wyprzedzeniem	to agree on sth ahead of time
wyjątek od reguły	an exception to the rule
robić wyjątek	to make an exception
wyjątek	an exception
w drodze wyjątku	as an exception
robić dla kogoś wyjątek	to make an exception for sb
wykonywać wiele zadań jednocześnie	to multitask
spełniać czyjeś standardy	to live up to sb's standards
spełniać coś	to live up to sth
krytyka	criticism
zaleta	a strength
używać siły	to use force
być szanowanym	to be respected
Nawet jeśli...	Even if...
powód czegoś	a reason for sth
wracać do pracy	to come back to work
do końca miesiąca	by the end of the month
Mam nadzieję, że...	I hope that...
dowiadywać się prawdy	to find out the truth
obiecywać coś	to promise sth
zdrowieć	to get better
być wściekłym	to be furious
wychodzić z łóżka	to get out of bed
być z kogoś dumnym	to be proud of sb
zakładać sukienkę	to put on a dress
odświeżać swój angielski	to refresh your English
mieć więcej czasu	to have more time
spotykać się ze znajomymi	to meet your friends
mieć problemy	to have problems
zachowanie	a behavior
szalony tydzień	a crazy week
bałagan	a mess
profesjonalny nauczyciel	a professional teacher
przynajmniej	at least
na razie	for now
rozważać coś	to consider sth
przemyśleć swoje zachowanie	to think over your behavior
twoja wina	your fault
być wspaniałym	to be gorgeous
połowa czegoś	half of sth
Zastanawiam się, czy...	I'm wondering if...
wredny	mean
opracowywać plan	to come up with a plan
robić coś inaczej	to do sth differently
robić właściwą rzecz	to do the right thing
formatować dokumenty	to format documents
schodzić na dół	to go downstairs
wiedzieć lepiej	to know better
usuwać coś	to remove sth
być niezależnym od kogoś	to be independent of sb
elastyczny harmonogram	a flexible schedule
elastyczne godziny pracy	flexible working hours
zostawać do końca	to stay till the end
dowód	proof
robić coś efektywnie	to do sth efficiently
wchodzić do branży	to enter the industry
wprowadzać hasło	to enter the password
samolot	an aircraft
wspinać się po drabinie	to climb the ladder
wspinać się na ścianę	to climb a wall
wspinać się na górę	to climb a mountain
wspinać się na drzewo	to climb a tree
tyć [2]	to gain weight; to put on weight
praca licencjacka	a Bachelor's thesis
praca magisterska	a Master's thesis
uczyć matematyki	to teach Math
wyleczyć się z choroby	to recover from a disease
zwiedzać	to do sightseeing
zajęta łazienka	an occupied bathroom
oliwka	an olive
być krytycznym	to be critical
porywać kogoś	to kidnap sb
porywać dziecko	to kidnap a child
porywacz	a kidnapper
mieć wakat	to have an opening
być innym od czegoś	to be different from sth
zadzierać z kimś	to mess with sb
zwalniać kogoś z pracy	to lay sb off
pula kandydatów	a pool of candidates
zawężać coś	to narrow sth down
zawężać pulę kandydatów	to narrow down a pool of candidates
hotel	a hotel
gościć swoich znajomych	to have your friends over
sprzątać	to clean up
bomba	a bomb
dostawać kredyt hipoteczny	to get a mortgage
kupować mieszkanie	to buy an apartment
mieć wprawę	to be skillful
zaczynać grać na pianinie	to take up the piano
przezwyciężać swój strach	to get over your fear
zakładać kurtkę	to put on a jacket
przekazywać obowiązki	to hand over responsibilities
być zjaranym	to be stoned
być pod obserwacją	to be under surveillance
trzymać kogoś pod obserwacją	to keep sb under surveillance
mieć dostęp do czegoś	to have access to sth
mają dostęp do opieki medycznej	to have access to medical care
mieć dostęp do Internetu	to have access to the internet
mieć dostęp do systemu	to have access to the system
pocztą	by mail
pojawiać się w pracy	to show up at work
być zamieszanym w narkotyki	to be mixed up in drugs
wracać do więzienia	to go back to jail
być głupim	to be stupid
wchodzić z kimś w konflikt	to come into conflict with sb
postrzelić kogoś	to shoot sb
kryminalista	a criminal
kończyć się	to be over
jeden z dwóch	one out of two
wychodzić z biura	to leave the office
dziewczyna	a girl
wyciągać broń	to pull out a gun
odrzucać zaproszenie na ślub	to turn down an invitation to the wedding
opinia	an opinion
myśleć o czymś	to think about sth
pozwalać na coś	to allow sth
rozpoczynać produkcję	to go ahead with the production
współczuć komuś	to feel for sb
dopijać kawę do końca	to drink up your coffee
lekarz pierwszego kontaktu	a GP
powtarzać się	to repeat yourself
wymagać analizy (nie: require, demand)	to call for an analysis
Moim zdaniem...	In my opinion...
zarabiać pieniądze [2]	to make money; to earn money
praca	a job
nalegać, żeby...	to insist that...
pistoletem	with a gun
nożem	with a knife
butelką	with a bottle
telefonem komórkowym	with a cell phone
młotkiem	with a hammer
wszystkie miejsca	all the places
wszystkie rzeczy	all the things
cała reszta	all the rest
wszystkie pieniądze	all the money
wszyscy ludzie	all the people
wszystkie dokumenty	all the documents
wszystkie informacje	all the information
wszystkie wspomnienia	all the memories
wszystkie państwa	all the countries
wszystkie zmiany	all the changes
cała miłość	all the love
wszystkie wiadomości	all the news
cała pomoc	all the help
być wkurwionym	to be pissed off
przejmować firmę	to take over a company
lubić coś robić	to like doing sth
podsumowywać coś	to wrap sth up
czuć się dobrze (o samopoczuciu)	to feel good
ograniczać picie alkoholu	to cut down on drinking
ustępować (o bólu)	to go away {2}
akceptować coś	to accept sth
proponować plan	to put forward a plan
wykonywać testament	to carry out your will
spisywać swój testament	to make your will
niezbędne materiały	the necessary materials
nadrabiać opóźnienie	to make up for a delay
rozważać za i przeciw	to weigh up the pros and cons
córka	a daughter
właściciel mieszkania	an apartment owner
bronić swoich interesów	to stand up for your interests
nie wchodzić komuś w drogę	to stay out of sb's way
rozważać dowody	to weigh up evidence
składać się z dwóch części	to be made up of two parts
ograniczać spożycie mięsa	to cut down on meat
uwydatniać to, co w kimś najlepsze	to bring out the best in sb
wysiadać (o prądzie)	to go off {4}
schrzanić pracę	to screw up a job
zepsuć się (o jedzeniu)	to go off {3}
wychodzić z baru	to leave the bar
pisać artykuł po angielsku	to write an article in English
sprawdzaćs słowo w słowniku	to look up a word in the dictionary
decydować się na coś (nie: opt)	to go for sth
dostawać wypłatę (nie: salary)	to get paid
iść z kimś do łóżka	to hook up
brać się w garść	to get a grip on yourself
Wielki Tydzień	Holy Week
Środa Popielcowa	Ash Wednesday
Wielki Czwartek [2]	Maundy Thursday; Holy Thursday
Wielki Piątek [2]	Good Friday; Holy Friday
Wielka Sobota [2]	Holy Saturday; Easter Eve
Wielkanoc	Easter
Poniedziałek Wielkanocny	Easter Monday
Wielki Post	Lent
pościć	to fast
święcić koszyk wielkanocny	to bless an Easter basket
ozdabiać jajko wielkanocne	to decorate an Easter egg
pisklę	a chick
króliczek	a bunny
żonkil	a daffodil
tulipan	a tulip
bazia	a catkin
cukrowy baranek	a sugar lamb
Niedziela Palmowa	Palm Sunday
być zamożnym	to be wealthy; to be well-off
burza	a storm
zaspokajać potrzeby swojego klienta	to meet your client's needs
udawać, że...	to pretend that...
być złym	to be mad
obrus	a tablecloth
doceniać coś	to appreciate sth
powstrzymywać się od czegoś	to refrain from sth
komentować	to make comments
być trzeźwym	to be sober
mieć wszystkie potrzebne informacje	to have all the information needed
ładowac laptopa	to charge a laptop
być perfekcyjnym kandydatem na coś	to be a perfect candidate for sth
znać angielski	to know English
kończyć z czymś	to be finished with sth
podwładny	a report
czekać	to wait
otwierać się	to open
przeklinać	to swear
być naprawdę wkurwionym	to be genuinely pissed off
palić jedzenie	to burn food
mieć z kimś rozmowę telefoniczną	to have a call with sb
błąd ortograficzny	a spelling mistake
czytać książki	to read books
przepisywać coś komuś	to prescribe sth to sb
kupować coś	to buy sth
być tanim	to be cheap
iść do bankomatu [2]	to go to the ATM; to go to the cash machine
wskaźnik	a rate
uzupełniać kogoś	to complement sb
płacić odsetki	to pay interest
zapominać o czymś	to forget about sth
mieć coś	to have sth
negocjować	to negotiate
zostać odrzuconym	to get rejected
przekazywać coś na czas	to hand sth on time
wypowiadać umowę (nie: agreement)	to terminate a contract
robić coś na czas	to do sth on time
cenić kogoś	to value sb
przeszkadzać komuś	to disturb sb
notować informacje	to note down information
traktować coś poważnie	to treat sth seriously
dobrze się rozwijać	to thrive
być bezczynnym	to be idle
myć zęby	to brush your teeth
czesać włosy	to brush your hair
spędzać czas, robiąc coś	to spend time on sth
niewiele pieniędzy	not much money
niewiele czasu	not much time
niewiele zabawy	not much fun
niewiele pomocy	not much help
niewiele rad	not much advice
niewiele informacji	not much information
niewiele wody	not much water
niewiele wiedzy	not much knowledge
niewiele dowodów	not much evidence
niewielki postęp	not much progress
niewiele jedzenia	not much food
niewiele pracy domowej	not much homework
niewiele rzeczy (nie: things)	not much stuff
niedużo przestrzeni	not much space
niewielu ludzi	not many people
niewiele razy	not many times
niewiele zwerząt	not many animals
niewielu uczniów	not many students
niewiele przyjaciół	not many friends
niewiele przykładów	not many examples
niewiele przypadków	not many cases
niewielu mężczyzn	not many men
niewiele kobiet	not many women
niewiele dzieci	not many children
niewiele pytań	not many questions
niewiele opcji	not many options
niewiele miejsc	not many places
niewiele rzeczy (nie: stuff)	not many things
niewielu graczy	not many players
niewielu z nas	not many of us
podwyżka płac [2]	a pay raise; a pay rise
mieć w czymś doświadczenie	to have experience in sth
ściszać muzykę	to turn down the music
rozmawiać z kimś (nie: talk)	to speak with sb
dostawać coś na urodziny	to get sth for your birthday
zabawka	a toy
udawać szczęśliwego	to pretend to be happy
odnosić odwrotny skutek	to backfire
w twoim rodzinnym mieście	in your hometown
dodawać coś do swojego kalendarza	to add sth to your calendar
grać w gry	to play games
posprzątać coś	to clean sth up
nalegać	to insist
zgadzać się	to agree
mierzyć coś	to measure sth
mieć odpowiednie narzędzia	to have the right tools
być szczęśliwym	to be happy
czytać wiadomość	to read a message
planować gdzieś pójść	to plan to go somewhere
utrzymywać kontakt wzrokowy	to keep eye contact
rządzić	to rule
być rozsądnym	to be reasonable
godziny pracy	working hours
działania marketingowe	marketing actions
docierać do swojej grupy odbiorców	to reach your target audience
rozwiązanie na coś	a solution for sth
być w stanie pomóc	to be able to help
mieć dzieci	to have kids
siedzieć	to sit
złożyć wypowiedzenie	to give notice
zrobić dobre wrażenie na kimś	to make a good impression on sb
aktualizować dane kontaktowe	to update contact details
próbować coś osiągnąć	to try to accomplish sth
rozpoznawać kogoś (nie: recognize)	to identify sb
napastnik	an assaulter
być w coś zaangażowanym	to be engaged in sth
angażować kogoś w rozmowę	to engage sb in the conversation
zastępować coś	to replace sb
brać tydzień wolnego	to take a week off
wracać samochodem do domu	to drive back home
wyciągać dziecko z łóżka	to get your child out of bed
tłumaczyć tekst	to translate a text
przepraszać za swoje błędy	to apologize for your mistakes
dział prawny	the legal department
jak również...	as well as...
osoba ekstrawertyczna	an extroverted person
mylić coś z czymś	to mistake sth for sth
sprawiać, żeby ktoś coś zrobił	to cause sb to do sth
pielęgnować coś	to foster sth
stanąć z powrotem na nogi	to get back on your feet
rozwód	a divorce
testować kogoś	to test sb
myśleć, że...	to think that...
być pozwanym	to be sued
ujawniać poufne informacje	to disclose confidential information
robić coś bez pozwolenia	to do sth without permission
grozić komuś	to threaten sb
kraść coś	to steal sth
płynąć wzdłuż wybrzeża	to coast
podlegać komuś	to report to sb
poprawiać coś	to correct sth
oświadczenie podatkowe	a tax declaration
leżeć na biurku	to lie on the desk
unikać kogoś	to avoid sb
szyć coś	to sew sth
opierać się pokusie, aby coś robić	to resist the temptation to do sth
dobrze coś rozumieć	to understand sth well
sugerować coś	to suggest sth
być na spotkaniu	to be at a meeting
podejście	an approach
wymagać czegoś	to require sth
zachowywać spokój	to stay calm
dzwonić do kogoś jeszcze raz	to call sb again
zakładać własny biznes	to set up your own business
być pod wrażeniem	to be impressed
mieć dla kogoś ofertę	to have an offer for sb
otrzymywać coś	to receive sth
otrzymywać zwrot kosztów	to receive reimbursement
wysyłać fakturę	to send an invoice
być obojętnym	to be indifferent
inwestować w projekt	to invest in a project
nie lubić kogoś	to dislike sb
dawać komuś znać, że...	to let sb know that...
pytać kogoś o zdanie	to consult with sb
etui	a case
być w biurze	to be in the office
uczęszczać na coś	to attend sth
kierować zespołem	to lead a team
piec	to bake
śmierdzieć	to smell
motywować	to motivate sb
podsumowanie	a summary
ograniczać się do czegoś	to limit yourself to sth
zaokrąglać coś do góry	to round sth up
zaokrąglać coś do dołu	to round sth down
zaokrąglać coś	to round sth
być sumiennym	to be conscientious
kiwać głową	to nod
podważać coś	to undermine sth
wyczerpywać coś	to deplete sth
wytrzymywać coś	to endure sth
obrażać kogoś	to insult sb
pragnąć czegoś	to desire sth
Ostatnim razem, kiedy rozmawialiśmy...	The last time we talked...
urozmaicać coś	to diversify sth
na trawie	on the grass
trawa	grass
drzewo	a tree
sadzić drzewo	to plant a tree
ścinać drzewo	to chop down a tree
deska toaletowa	a toilet seat
onieśmielać kogoś	to intimidate sb
wkrótce	shortly
w skrócie	in short
przyznawać coś	to admit sth
być czegoś pewnym	to be sure about sth
pojawiać się na imprezie	to show up at the party
wystawiać kogoś	to stand sb up
unikać odpowiedzialności	to avoid responsibility
pracować na nocną zmianę	to work the night shift
pracować w weekend	to work on the weekend
członek zespołu	a team member
pobłażliwy nauczyciel	a lenient teacher
być zamkniętym (na klucz)	to be locked
być surowym	to be strict
następnym razem	next time
pracować jako sędzia	to work as a judge
sędzia	a judge
termin porodu	a due date
trwać godzinę	to last an hour
wymyślać wymówkę	to make up an excuse
nakładać makijaż	to put on makeup
nakładać krem z filtrem	to put on sunscreen
zapominać o przeszłości (nie: forget)	to let go of the past
puszczać fajerwerki	to let off fireworks
na konferencji	at the conference
w grupie	in the group
znajdować coś	to find sth
inny	different
od razu	right away
zasługiwać na coś	to deserve sth
zaczynać nową pracę	to start a new job
gotować coś	to cook sth
mimo że	even though
pracować z domu	to work from home
iść do biura	to go to the office
natychmiast	immediately
wzywać policję	to call the police
być przygnębionym	to be depressed
coś do jedzenia	sth to eat
znać kogoś	to know sb
zaczynać naukę języka angielskiego	to start learning English
... kiedy byłem studentem	...when I was a student
potrzebować czegoś	to need sth
sprzedawać dom	to sell a house
papieros	a cigarette
wychodzić na miasto [2]	to go out; to hang out
przeprowadzić się do Warszawy	to move to Warsaw
spotykać się	to meet
opłata za wejście	an entry fee
mieć cukrzycę	to have diabetes
zakochiwać się w kimś (nie: for)	to fall in love with sb
gratulować komuś czegoś	to congratulate sb on sth
uczyć się czegoś na test	to study sth for a test
jeden z twoich klientów	one of your clients
rozmawiać z kimś osobiście	to talk to sb in person
motyw przewodni imprezy	a theme of a party
szwagier	a brother-in-law
siostrzenica	a niece
bratanek	a nephew
zaciągać kredyt hipoteczny	to take out a mortgage
być podejrzliwym	to be suspicious
spotykać się na Teamsach	to meet on Teams
mieć profil na facebooku	to have a profile on Facebook
trwać miesiąc	to be a month long
miesięczny projekt	a month-long project
być zdenerwowanym	to be nervous
być spiętym	to be tense
napięta atmosfera	a tense atmosphere
być pojedynczym	to be singular
wykonywać coś	to carry sth out
{\rtf1\ansi\ansicpg1250\deff0\nouicompat\deflang1045{\fonttbl{\f0\fnil\fcharset0 Calibri;}{\f1\fnil\fcharset238 Calibri;}}	
{\*\generator Riched20 10.0.19041}\viewkind4\uc1	
}	
być przyjacielskim	to be friendly
być na coś podekscytowanym	to be excited about sth
zajmować się dzieckiem	to take care of the kid
obciążać kogoś	to incriminate sb
nosić dresy	to wear sweatpants
wchodzić do budynku	to enter a building
myjnia samochodowa	a car wash
być nierealistycznym	to be unrealistic
prowadzić projekt	to lead a project
﻿być chętnym coś zrobić	to be willing to do sth
denerwować kogoś	to annoy sb
wymagać dużo pracy	to require a lot of work
wymagać dużo czasu	to require a lot of time
wymagać wyjaśnienia	to require explanation
cała rada	all the advice
całe powietrze	all the air
cała złość	all the anger
cały chaos	all the chaos
cała kawa	all the coffee
całe wyposażenie	all the equipment
cała motywacja	all the motivation
cały stres	all the stress
cały transport	all the transportation
całe mieszkanie	the whole apartment
całe ciało	the whole body
cała książka	the whole book
cały budynek	the whole building
całe miasto	the whole city
cała rodzina	the whole family
cały dom	the whole house
cały pomysł	the whole idea
cały film	the whole movie
cały problem	the whole problem
cała sytuacja	the whole situation
cała historia	the whole story
cały temat	the whole subject
cała prawda	the whole truth
cały świat	the whole world
ciśnienie krwi	blood pressure
tętno	a heart rate
opłakiwać kogoś	to mourn sb
łagodny symptom	a mild symptom
dawka	a dose
dbać o kogoś	to take care of sb
być religijnym	to be religious
być bogobojnym	to be God-fearing
wierzyć w Boga	to believe in God
płacić za coś w ratach	to pay for sth in installments
na dłuższą metę	in the long run
wynikać z czegoś	to stem from sth
siedzieć do późna	to sit up late
﻿wynajmować komuś mieszkanie	to rent out an apartment to sb
przyspieszać [2]	to accelerate; to speed up
pędzić	to speed
wkuwać na test	to cram for a test
troszczyć się o swoją rodzinę	to care about your family
przemoc domowa	domestic violence
wpadać w kłopoty	to get in trouble
nie pochwalać czegoś	to disapprove of sth
zgadywać coś	to guess sth
przeglądać Facebooka	to scroll Facebook
działać w obie strony	to work both ways
oddychać	to breathe
metafora	a metaphor
subskrypcja	a subscription
błędne koło	a vicious circle
doładowywać telefon	to top up your phone
grać na perkusji	to play drums
koncert	a gig
wykopywać kogoś	to kick sb out
dosłownie	literally
w ostatniej scenie	in the last scene
w ostatniej pracy	in the last job
pobierać od kogoś opłatę za coś	to charge sb for sth
pobierać od kogoś dodatkową opłatę	to charge sb extra
działać w obie strony/to work both ways	
oddychać/to breathe	
metafora/a metaphor	
wspominać coś komuś/to mention sth to sb	
subskrypcja/a subscription	
błędne koło/a vicious circle	
doładowywać telefon/to top up your phone	
grać na perkusji/to play drums	
koncert/a gig	
wykopywać kogoś/to kick sb out	
dosłownie/literally	
ostatni sezon/the last season	
w ostatniej scenie/in the last scene	
w ostatniej pracy/in the last job	
pierwszy semestr/the first semester	
pobierać od kogoś opłatę za coś/to charge sb for sth	
pobierać od kogoś dodatkową opłatę/to charge sb extra	
robić grilla	to have a barbecue
jechać na wycieczkę do miasta	to go on a city break
jechać na camping	to go camping
iść popływać kajakami	to go canoeing
pływać kajakiem	to go kayaking
iść na wędrówkę	to go hiking
mieć piknik	to have a picnic
grać w tenisa	to play tennis
iść do parku rozrywki	to go to a theme park
rozpieszczać się w spa	to pamper at the spa
przejechać się rollercoasterem	to take a rollercoaster ride
iść na degustację wina	to go wine tasting
zbliżać się do kogoś	to approach sb
słuchać czegoś	to listen to sth
grać w grę	to play a game
grać w karty	to play cards
grać w piłkę nożną	to play soccer
grać na gitarze	to play the guitar
grać na pianinie	to play the piano
wyznaczać granicę	to set a boundary
brać udział w protestach antywojennych	to take part in anti-war protests
przygotowywać kogoś do czegoś	to prepare sb for sth
robić coś na zmianę	to take turns
lądować	to land
biadolić	to whine
skutkować czymś	to result in sth
skutkować utratą wagi	to result in weight loss
iść na urlop macierzyński	to go on maternity leave
iść na urlop ojcowski	to go on paternity leave
choroba [3]	a sickness; an illness; a disease
schronienie	a shelter
ostatecznie [2]	in the end; eventually
na koniec miesiąca	at the end of the month
na koniec podróży	at the end of the trip
na końcu filmu	at the end of the movie
data ważności	an expiry date
wygasać (o umowie)	to expire
usuwać tatuaż	to remove a tattoo
dom spokojnej starości	a retirement home
trumna	a coffin
składać stół	to put together a table
łóżeczko dziecięce	a crib
składać coś [2]	to assemble sth; to put sth together
kończyć jak ktoś	to end up like sb
zarywać nockę	to pull an all-nighter
upewniać się, że...	to make sure that...
besztać kogoś	to scold sb
komnata	a chamber
przykazanie	a commandment
uczta	a feast
kilka razy w miesiącu	a few times a month
kilka razy w tygodniu	a few times a week
kilka razy w roku	a few times a year
mucha	a fly
żywopłot	a hedge
pies (nie: dog)	a hound
liść	a leaf
kącik	a nook
salon (np. kosmetyczny)	a parlor
gołąb	a pigeon
wróżba	a prophecy
pogłoska	a rumour
zardzewiały klucz	a rusty key
stajnia	a stall
kolec	a thorn
łopatka wentylatora	a vane
Minął rok...	A year has gone by...
w końcu	at last
pięć razy w tygodniu	five times a week
len	flax
raz dziennie	once a day
raz w miesiącu	once a month
raz w roku	once a year
riches	riches
trzy razy dziennie	three times a day
trzy razy w miesiącu	three times a month
trzy razy w tygodniu	three times a week
trzy razy w roku	three times a year
stanąć w miejscu	to become still
schylać się	to bend
przyznawać coś komuś	to bestow sb sth
wydawać dziecko na świat	to bring a child into the world
spalić coś	to burn sth up
pełzać	to creep
dobiegać końca	to draw to an end
padać martwym	to fall down dead
zapadać w głęboki sen	to fall into a deep sleep
migotać (o płomieniu)	to flicker
wróżyć coś	to foretell sth
spełniać życzenie	to fulfill a wish
mijać (o czasie)	to go by
ruszać naprzód	to go forth
oglądać się za siebie	to look round
wspinać się wyżej	to mount higher
rozchodzić się	to part
przechodzić przez płot	to pass the fence
piec się	to roast
chronić kogoś przed nieszczęściem	to save sb from misfortune
kucać na ziemi	to squat on the ground
wystawać z czegoś	to stick out of sth
garbić się (nie: slouch)	to stoop
przekręcać klucz	to turn a key
odwracać się	to turn away
skręcić się	to twist round
machać ogonem	to wag your tail
przechadzać się	to wander about
dwa razy dziennie	twice a day
dwa razy w miesiącu	twice a month
dwa razy w tygodniu	twice a week
dwa razy w roku	twice a year
cnota	virtue
ze zdumieniem	with wonderment
pracować jako menedżer	to work as a manager
pracować jako wykładowca	to work as a lecturer
pracować jako lekarz	to work as a doctor
pracować jako księgowa	to work as an accountant
pracować jako blogger	to work as a blogger
pracować jako nauczyciel	to work as a teacher
pracować jako detektyw	to work as a detective
pracować jako analityk	to work as an analyst
pracować jako stażysta	to work as an intern
pracować jako asystentka	to work as an assistant
pracować jako dziennikarz	to work as a journalist
pracować jako freelancer	to work as a freelancer
pracować jako taksówkarz	to work as a cab driver
pracować jako kucharz	to work as a cook
pracować jako prawnik	to work as a lawyer
pracować jako aktor	to work as an actor
być wzruszającym	to be touching
wierzyć w coś	to believe in sth
zabierać kogoś do restauracji	to take sb to a restaurant
płacić ratę	to pay an installment
mieć pasję do czegoś	to have a passion for sth
chrapać	to snore
rozważać zrobienie czegoś	to consider doing sth
spać osobno	to sleep separately
spać razem	to go to sleep together
sugestia	a suggestion
przejmować się czymś	to care about sth
uczyć się, jak coś robić	to learn how to do sth
wkuwać na egzamin	to cram for the exam
stosować się do czegoś	to comply with sth
dotacja	a subsidy
mieć na kogoś wpływ	to have an impact on sb
płótno malarskie	canvas
malować	to paint
sukces	a success
komunikować się	to communicate
pracować do późna	to work late
przeceniać coś	to overestimate sth
chcieć coś zrobić	to want to do sth
przerabiać temat	to cover a subject
robić coś na lekcji	to do sth in class
wiedzieć o czymś	to know about sth
zapobiegać rozprzestrzenianiu się choroby	to prevent the spread of disease
ambasada	an embassy
kurczyć się	to shrink
pić zdecydowanie za dużo	to drink way too much
robić coś zbyt często	to do sth way too often
mieć wolny termin	to have a free slot
znajdywać wolne miejsce	to find a free slot
były prezydent	a former president
dawny kolega z pracy	a former colleague
ten pierwszy	the former
ten ostatni (nie: last)	the latter
rozpieszczać swoje dzieci	to spoil your kids
rozwydrzony bachor	a spoiled brat
powtarzać sobie skrypt	to rehearse the script
robić próbę przedstawienia	to rehearse a play
próba (nie: attempt, trial)	a rehearsal
﻿czuć się źle z powodu czegoś	to feel bad about sth
czuć się dobrze z czymś	to feel good about sth
czuć się dobrze we własnej skórze	to feel good about yourself
czwartek	Thursday
myśleć	to think
brać taksówkę	to take a cab
otwierać konto	to open an account
patrzeć na siebie nawzajem	to look at each other
rozmawiać ze sobą nawzajem	to talk to each other
wołowina	beef
wieprzowina	pork
jelito cienkie	a small intestine
jelito grube	a large intestine
język (część ciała)	a tongue
żołądek	a stomach
wątroba	a liver
nerka	a kidney
pęcherz moczowy	a bladder
serce	a heart
śledziona	a spleen
mózg	a brain
trzustka	a pancreas
tarczyca	a thyroid
zwracać uwagę na szczegóły	to pay attention to detail
umniejszać coś	to diminish sth
żuć gumę	to chew a gum
zapisywać się na kurs	to sign up for a course
prokurator okręgowy	a district attorney
nosić maseczki	to wear face masks
policzyć komuś (do zapłaty)	to charge sb
chwalić się czymś	to brag about sth
zmniejszać się	to drop
akcja	a share
przyjeżdżać póżniej	to arrive later
impreza	a party
wybór (nie: choice)	an election
pozwalać komuś coś zrobić	to let sb do sth
zaprzeczać prawdzie	to deny the truth
ładować telefon komórkowy	to charge your cell phone
wapń	calcium
jagnię	a lamb
borykać się z czymś	to struggle with sth
składnik odżywczy	a nutrient
węglowodany [2]	carbohyrates; carbs
mieć dużo węglowodanów (nie: have) [2]	to be high in carbs; to be high in carbohydrates
niezbędny składnik odżywczy (nie: important, vital, significant)	an essential nutrient
odbierać dziecko ze szkoły	to pick up a kid from school
uświadamiać komuś coś	to make sb realize sth
skłaniać kogoś do myślenia	to make sb think
sprawiać, by ktoś znikał	to make sb disappear
wyprowadzać się z mieszkania	to move out of an apartment
kosić trawnik	to mow the lawn
kosiarka	a lawn mower
przycinać coś	to trim sth
być nieuprzejmym wobec kogoś	to be impolite to sb
skrót	an abbreviation
następny krok	the next step
następnego ranka	the next morning
mieć wolność słowa	to have freedom of speech
pierwszy rozdział	the first chapter
być wpływowym	to be influential
Azja	Asia
bielizna damska (nie: underwear)	lingerie
zagrożenie	a menace
brać winę za coś	to take the blame for sth
zawalać się	to collapse
całkowicie	totally
polityk	a politician
cel	a goal
gol	a goal {2}
być zbyt leniwym, żeby coś robić	to be too lazy to do sth
wprowadzać coś na rynek	to roll sth out
nie mieć czasu	to have no time
robić coś z czymś	to do sth about sth
iść do fryzjera	to have your hair cut
lubić swoje sąsiedztwo	to like your neighborhood
zmieniać temat	to change the subject
ukrywać coś przed kimś	to hide sth from sb
radzić sobie z problemem (nie: problem)	to deal with an issue
ofiara czegoś	a victim of sth
bluza z kapturem	a hoodie
prać coś w temperaturze	to wash sth at a temperature
myśleć o swojej rodzinie	to think about your family
czekać na kogoś, żeby coś zrobił	to wait for sb to do sth
być z czymś związanym	to be related to sth
sprawić, że ktoś poczuje się silny	to make sb feel strong
woda święcona	holy water
według czegoś	according to sth
zgodnie z polskim prawem	according to the Polish law
w szczerym polu	in the middle of nowhere
broda	a beard
wymigiwać się od czegoś	to get away with sth
docierać do celu	to reach your destination
być pełnym napięcia	to be suspenseful
wyciekać	to leak
iść do mechanika, żeby naprawić samochód	to get your car fixed
sprawiać, że ktoś się uczy angielskiego	to make sb learn English
być wdzięcznym komuś za coś	to be grateful to sb for sth
odkrywać coś	to discover sth
zapobiegać czemuś	to prevent sth
obijać się	to laze around
ruszać dupę do pracy	to get your ass to work
być skazanym za coś	to be convicted of sth
wyrażać swoje uczucia	to express your feelings
usypiać kogoś	to make sb sleep
utrudniać komuś życie	to make sb's life harder
pomagać sobie nawzajem	to help each other
wyrzucać kogoś z domu	to throw sb out of the house
iść na trening piłki nożnej	to go to soccer practice
usuwać plamę	to remove a stain
wychodzić (o filmie)	to come out
rzeczniczka	a spokeswoman
dyrektor	a director
orkiestra	an orchestra
konduktor	a conductor
uważnie kogoś słuchać	to listen to sb carefully
Niedziela Wielkanocna	Easter Sunday
mieć zapalenie oskrzeli	to have bronchitis
oskrzela	bronchi
mieć zapalenie zatok	to have sinusitis
zatoki przynosowe	sinuses
stan zapalny	an inflammation
manipulować kimś, aby ta osoba zwątpiła w swoje zdrowie psychiczne	to gaslight sb
steroid	a steroid
mieć opryszczkę	to have herpes
robić sobie tatuaż	to get a tattoo
Najpierw...	At first...
robić rozgrzewkę	to have a warm-up
robić deskę (ćwiczenie na brzuch)	to do a plank
robić pajacyka	to do a jumping jack
robić brzuszek	to do a crunch
robić rowerek	to do a bicycle crunch
robić przysiad	to do a squat
robić pompkę	to do a push-up
robić nożyce poziome (ćwiczenie na brzuch)	to do scissors
zwiększać wytrzymałość	to increase endurance
wykonywać ćwiczenie	to perform an exercise
biegać na bieżni	to run on a treadmill
mieć trenera personalnego	to have a personal trainer
podnosić ciężary	to lift weights
brać suplementy	to take supplements
spalać tłuszcz	to burn fat
budować mięśnie	to build muscle
deska do nauki pływania	a kickboard
w górach	in the mountains
zginać kolana	to bend your knees
kończyć osiemnaście lat	to turn eighteen
ratownik wodny	a lifeguard
robić cardio	to do cardio
mieć niedobór	a have a deficiency
naśladować kogoś	to imitate sb
brzmieć znajomo (nie: sound)	to ring a bell
